mal	home
mal	house
xanî	house
xanî	home
mêr	man
mêr	husband
nefer	person
nefer	individual
welat	country
welat	fatherland
par	share
par	part
kel	thing
kel	heat
desthilat	power
desthilat	authority
şeher	city
şeher	town
xurek	food
xurek	nourishment
şev	night
şev	evening
hikûmet	government
hikûmet	administration
zar	word
zar	language
werar	development
werar	growth
heval	friend
heval	comrade
dabaş	subject
dabaş	topic
tendirûstî	health
tendirûstî	hygiene
cade	road
cade	street
tebîet	nature
tebîet	essence
heyam	period
heyam	while
nivîskar	author
nivîskar	writer
dêr	church
dêr	monastery
alav	fire
alav	flame
ewlehî	security
ewlehî	safety
ziman	language
ziman	tongue
delîl	evidence
delîl	document
rastî	reality
rastî	truth
şiverê	path
şiverê	trail
bawer	faith
bawer	belief
hediye	gift
hediye	present
vexwarin	drink
vexwarin	drinking
alî	direction
alî	course
şîv	dinner
şîv	supper
bare	topic
bare	hashtag
ba	weather
ba	wind
tav	sun
tav	sunlight
bijîşk	doctor
bijîşk	physician
nojdar	doctor
nojdar	physician
hevrikî	competition
hevrikî	rivalry
mamoste	teacher
mamoste	master
xwarin	eating
xwarin	food
terazî	balance
terazî	scales
goşe	corner
goşe	angle
dezî	thread
dezî	cotton
pî	foot
pî	pi
stêr	star
stêr	celebrity
keştî	boat
keştî	ship
sefa	pleasure
sefa	tranquility
efsûnî	magic
efsûnî	sorcery
don	fat
don	grease
şeref	honor
şeref	glory
namûs	honor
namûs	decency
roj	sun
roj	day
vagon	coach
vagon	wagon
çîn	layer
çîn	stratum
edalet	justice
edalet	law
tebax	oven
tebax	august
rojava	west
rojava	occident
piranî	majority
piranî	plurality
ken	laugh
ken	smile
temînat	guarantee
temînat	insurance
feyde	profit
feyde	advantage
ling	leg
ling	foot
leşker	army
leşker	military
çerx	wheel
çerx	century
çiq	branch
çiq	twig
çiqil	branch
çiqil	hook
hesin	iron
hesin	anchor
salname	calendar
salname	yearly
gol	flower
gol	rose
encumen	council
encumen	committee
qerf	joke
qerf	pleasantry
pêkenok	joke
pêkenok	anecdote
alet	instrument
alet	tool
çeper	fence
çeper	hedge
mesîl	valley
mesîl	wadi
dîk	cock
dîk	rooster
saw	terror
saw	horror
şayîr	poet
şayîr	singer
xwenda	educated
xwenda	literate
cildank	wardrobe
cildank	closet
beşdar	participant
beşdar	shareholder
zîha	dragon
zîha	serpent
bezok	runner
bezok	racer
ferheng	dictionary
ferheng	culture
pincar	greens
pincar	vegetable
mar	snake
mar	marriage
xerîb	stranger
xerîb	foreigner
dexl	grains
dexl	cereals
malper	homepage
malper	website
dêw	demon
dêw	ogre
ade	weed
ade	island
alek	cheek
alek	jowl
maran	pantry
maran	larder
qehpik	whore
qehpik	prostitute
qesem	oath
qesem	vow
heyf	vengeance
heyf	revenge
çîmen	meadow
çîmen	lawn
kalan	sheath
kalan	scabbard
sexbêr	caretaker
sexbêr	monitor
mêrkuj	assassin
mêrkuj	murderer
tabûr	battalion
tabûr	squadron
kat	sprout
kat	growth
çiyayî	mountainous
çiyayî	hilly
ga	ox
ga	bull
tizbî	rosary
tizbî	chaplet
qîzik	sissy
qîzik	hermaphrodite
bî	willow
bî	poplar
sîtil	pail
sîtil	bucket
zîlik	clitoris
zîlik	vagina
zava	bridegroom
zava	son-in-law
gundor	cantaloupe
gundor	muskmelon
şênî	inhabitant
şênî	dweller
akincî	inhabitant
akincî	dweller
rûniştvan	inhabitant
rûniştvan	dweller
sîxur	porcupine
sîxur	spy
muxtar	headman
muxtar	plenipotentiary
sor	red
sar	cold
inglîzî	english
elmanî	german
nemir	immortal
herheyî	immortal
giran	heavy
hetahetayî	eternal
xwas	barefoot
asîstan	assistant
hêvîdar	hopeful
erotîk	erotic
hêsan	easy
zanistî	scientific
bêwate	meaningless
bênaverok	contentless
bêbav	fatherless
dirêj	long
girîng	important
îtalî	italian
polonî	polish
biencam	resultful
teknîkî	technical
dêm	arid
şor	salty
xemgîn	sad
zirav	thin
kedî	domestic
erzan	cheap
siyasî	political
êzidi	yezidi
rusî	russian
norwecî	norwegian
çima	why
jixwe	anyway
nexwe	then
erê	yes
carinan	sometimes
îşev	tonight
pirr	very
can	soul
zero	blond
dar	tree
ban	roof
dua	prayer
bend	slave
made	material
sal	year
dev	mouth
mer	spade
se	dog
der	door
mast	yoghurt
operator	surgeon
bar	burden
ser	head
pale	worker
pare	money
mange	cow
cot	pair
rex	side
vir	lie
dem	time
tale	happiness
bab	father
av	water
asin	iron
dad	justice
dû	smoke
pal	side
dot	daughter
bin	bottom
mirar	carcass
çay	tea
birader	brother
bira	brother
cam	glass
defter	notebook
lot	jump
fir	flight
qat	floor
gav	step
meh	month
post	skin
kerb	hatred
gul	flower
bela	affliction
perr	paper
daxwazname	invitation
kurdî	kurdish
nav	name
gû	shit
pene	secret
tib	medicine
aymara	aymara
bihar	spring
hundur	inside
gan	fucking
til	finger
dost	friend
mî	sheep
bombe	bomb
seda	voice
bajar	city
gog	ball
hel	solution
kurmancî	kurmanji
kurdmancî	kurmanji
hibir	ink
kok	root
sê	three
rez	vineyard
mij	mist
havîn	summer
nal	horseshoe
kap	rope
mak	mother
baran	rain
nar	fire
ilm	knowledge
fis	fart
merov	human
neder	appearance
teker	wheel
zad	food
gor	grave
mişk	mouse
qelb	heart
agir	fire
dil	heart
qehwe	coffee
kanêje	cornflower
diş	sister-in-law
mirin	death
guh	ear
kade	gata
guman	doubt
kurd	kurd
aren	elbow
oc	revenge
zayend	sex
pêşmerge	peshmerga
aş	mill
ceng	war
yasa	law
ney	ney
mîl	pointer
kefen	shroud
bav	father
namzet	candidate
fikir	thought
ceh	barley
parsek	beggar
torin	grandchild
çok	knee
dê	mother
pesin	praise
orgazm	orgasm
kanî	spring
aştî	peace
portugalî	portuguese
tilyak	drug
narkotîk	drug
gêlaz	cherry
sirişt	nature
xweza	nature
xwerist	nature
sîleh	arm
bakur	north
rû	face
xew	sleep
mereq	curiosity
balkêşî	interest
faîz	interest
derî	door
keman	violin
viyolîn	violin
merg	death
piyes	play
pirtûk	book
kitêb	book
avrêl	april
pêncşem	thursday
xwendingeh	school
medrese	school
sîr	garlic
yane	club
lêv	lip
reh	root
cenaze	corpse
antrenor	coach
nebî	prophet
pêxember	prophet
qefes	cage
pîşe	profession
meslek	profession
hokar	profession
bîrkarî	mathematics
amerîka	america
havil	solution
gulan	may
balyozxane	embassy
konsolosxane	embassy
gur	wolf
sifir	zero
dinya	world
firrinde	bird
balinde	bird
dayik	mother
otomobîl	car
ker	mule
rih	beard
rî	beard
tebeq	floor
baxçe	garden
çande	culture
kultûr	culture
deq	tattoo
kolonî	colony
ajovan	driver
xezeb	wrath
qûn	ass
hevok	sentence
dûxan	smoke
nîr	yoke
pêşbazî	competition
pêşbirk	competition
berbijar	candidate
xalxalok	ladybug
hêstir	mule
kareba	electricity
ocax	oven
volkan	volcano
zerik	yolk
gilî	complaint
şikayet	complaint
pirteqal	orange
qanûn	law
zagon	law
pêlav	shoe
kund	owl
kilîl	key
mift	key
enextar	key
xox	peach
hirmî	pear
rojî	fast
tîr	arrow
kemer	belt
lehî	flood
çerm	skin
enî	forehead
tov	seed
kudik	piglet
mêş	fly
kardînal	cardinal
kevan	bow
pirrjimar	plural
zelam	man
afret	woman
bêrî	longing
perwerde	education
piyale	glass
elektrîk	electricity
tenûr	oven
nêm	pus
danûstandin	negotiation
şerr	war
zimannasî	linguistics
bilûr	flute
fîq	flute
misilman	muslim
casûs	spy
diznêr	spy
garantî	guarantee
abone	subscriber
agirbest	ceasefire
balans	balance
hevsengî	balance
bilbil	nightingale
oksîjen	oxygen
karbon	carbon
kêç	flea
petêx	melon
qawin	melon
bûk	bride
sefîr	ambassador
rîx	dung
dijmin	enemy
kakût	skeleton
şilêl	rye
çewder	rye
tarîgan	rye
baçîk	rye
tû	mulberry
navgir	infix
peykel	statue
heykel	statue
spanî	spaniard
qonax	stage
gihanek	stage
xar	marble
dînar	dinar
malnişîn	retiree
teqawid	retiree
bostan	garden
afrîkansî	afrikaans
komîte	committee
lijne	committee
farisî	persian
nalet	curse
parêzgeh	province
wîlayet	province
eyalet	province
dêlegur	she-wolf
guhar	earring
dadgeh	tribunal
mehkeme	tribunal
tirr	fart
e-pirtûk	e-book
mozik	calf
ewr	cloud
xaç	cross
flamî	flemish
qetran	tar
pir	bridge
pergal	system
kilox	skull
mêtingeh	colony
eman	mercy
hirç	bear
qesel	germander
berîk	pocket
polîtolojî	politology
rûnas	bedstraw
tizrûg	leech
saqî	bartender
hilbijêr	chooser
jor	top
gembol	watchdog
navûdeng	fame
zevî	farmland
genim	wheat
cotmeh	october
pûşper	june
tîrmeh	july
hevîr	dough
pîrozbahî	celebration
hestî	bone
rengdêr	adjective
lêker	verb
diran	tooth
aborînas	economist
pirs	question
asanî	facility
wate	meaning
heyranî	admiration
birêveberî	administration
cotkarî	agriculture
dijminatî	antagonism
hoker	adverb
tayîn	appointment
ciwan	adolescent
ciwanî	adolescence
dewlemendî	affluence
zengînî	affluence
maldarî	affluence
dilsozî	adherence
hewes	ardour
dengûdor	ado
gozek	anklebone
karûbar	affair
asteng	obstruction
azadî	freedom
aborî	economy
dîrok	history
cudaxwazî	separatism
derûnnasî	psychology
diltengî	narrow-mindedness
binpêkirin	violation
ajalnasî	zoology
baregeh	headquarter
civak	society
zindankirin	imprisonment
zimannas	linguist
zanist	science
zanistvan	scientist
werger	translation
wergêr	translator
xwendekar	student
xwendevan	reader
xweserî	autonomy
xwedîmaf	beneficiary
egîdî	heroism
egîd	hero
bêhêvîtî	hopelessness
parêzer	lawyer
fonetîk	phonetics
hesp	horse
binrûpel	subpage
latînî	latin
nivîs	writing
parzemîn	continent
cejin	celebration
girtîgeh	prison
golik	calf
gotar	article
hejmar	number
cotkar	farmer
serokdewlet	president
xwaringeh	restaurant
pirtûkxane	library
jîrî	brightness
biratî	brotherhood
hunermend	artist
serbajar	capital
huner	art
ketin	fall
biwêj	idiom
stêrnasî	astronomy
daristan	forest
çem	river
dawî	end
demsal	season
sedsal	century
goristan	cemetery
alîkarî	help
alîkar	helper
lepik	glove
balafir	airplane
balafirvan	pilot
balafirgeh	airport
naverok	content
hevaltî	friendship
kujêr	murderer
kundir	pumpkin
rêziman	grammar
jiyan	life
zêr	gold
bêr	shovel
nûjenî	modernity
serhildan	uprising
mêvan	guest
endam	member
birek	saw
kadîn	barn
bêjing	sieve
xewn	dream
kulîlk	flower
giya	grass
çiya	mountain
birîn	wound
bersiv	response
astronomî	astronomy
civaknasî	sociology
sosyolojî	sociology
girav	island
dirav	money
watenasî	semantics
bêjenasî	etymology
rovî	fox
rûmet	dignity
erdhej	earthquake
armanc	aim
endezyarî	engineering
nivîsbarî	software
qût	food
danegeh	database
bernamekirin	programming
hevwate	synonym
navdêr	substantive
evîn	love
evîndar	lover
cihûtî	judaism
cihû	jew
binkom	subset
rêxistin	organization
hezarsal	millennium
gêzer	carrot
biyok	quince
pîvaz	onion
jinebî	widow
nîgarvan	painter
nîvgirav	peninsula
kurtenav	abbreviation
girtî	closed
ajans	agency
pêşdîrok	prehistory
paşxwarin	dessert
kapîtalîzm	capitalism
paqijî	cleanliness
paqijker	cleaner
realîzm	realism
sosyalîst	socialist
masîgir	angler
biguman	doubtful
tîprêzî	typography
nêtarî	neutrality
dengdar	consonant
helbest	poem
welatparêz	patriot
welatparêzî	patriotism
tîrbûn	density
nîveşkêl	radius
bikarhêner	user
asparagîn	asparagine
valageh	space
rêgeh	orbit
peyam	message
e-peyam	e-mail
kovar	magazine
heftename	weekly
têkilî	contact
belavok	flyer
pirsgirêk	problem
bername	program
penaberî	refugeehood
împeratorî	empire
împerator	emperor
lêkolîner	investigator
lêkolîn	investigation
parêzerî	lawyering
civaknas	sociologist
parzemînî	continental
serok	leader
nexweşî	sickness
pisîk	cat
kûçik	dog
kitik	cat
girêdan	link
neteweyî	national
netewe	nation
piştgirî	support
mamosta	teacher
vokatîv	vocative
belediye	municipality
beraz	pig
xwîn	blood
peyv	word
lêgerîn	search
pispor	specialist
qad	square
dêm	face
çapemenî	press
civîn	assembly
bizin	goat
mîz	urine
xebatkar	worker
bazirganî	trade
nasname	identity
tirk	turk
ûr	rumen
bûyer	event
amfetamîn	amphetamine
hîstamîn	histamine
bindestî	bondage
marmasî	eel
başî	benefaction
mekteb	school
evîndarî	love
boç	tail
pûrt	feather
vîkîng	viking
sivore	squirrel
hefte	week
fîl	elephant
hêlîn	nest
zarok	child
xiyar	cucumber
bafûn	aluminium
jêr	bottom
candar	animal
berx	lamb
berxwedan	resistance
rewşenbîr	intellectual
soranî	sorani
bîd	willow
êzdî	yazidi
paytext	capital
ceza	punishment
wêranker	ravager
êvar	evening
wêne	picture
ambûlans	ambulance
arkeolojî	archeology
anatomî	anatomy
anîmasyon	animation
toksîn	toxin
makîne	machine
deîzm	deism
bîrov	eczema
hêjatî	dearness
tarîkirin	darkening
darik	wood
nasyonalîzm	nationalism
nasyonalîst	nationalist
çîrok	story
kelex	corpse
nîtrojen	nitrogen
kevok	dove
şorbe	soup
îsot	pepper
kîr	penis
şêr	lion
hîv	moon
rêz	order
zîv	silver
dasî	fishbone
arşîv	archive
hêlekan	swing
mizgeft	mosque
gûz	walnut
rexne	criticism
tazîtî	nakedness
bêcilî	undressedness
xemgînî	sadness
nifir	curse
zirav	gall
pîrozî	holiness
quz	vagina
mewîj	raisin
xwedî	owner
sêşem	tuesday
çarşem	wednesday
pitik	suckling
bizmar	nail
mentiq	speech
naxir	herd
cîzme	boots
çêlek	cow
êzing	wood
fîstan	dress
kelem	cabbage
hîndarî	exercise
jîyan	life
lênûsk	notebook
yekîtî	unity
şose	highway
frensa	france
frensî	frenchman
binefş	violet
pembû	cotton
zaroktî	childhood
neynik	mirror
hizir	thought
şerm	shame
pişt	back
destmal	handkerchief
dûv	tail
esman	sky
fîncan	cup
şembî	saturday
cehnem	hell
cemed	ice
cewab	answer
çadir	tent
çal	pit
wext	time
çax	time
çayîr	meadow
sêşemî	tuesday
stirî	horn
guneh	sin
înî	friday
birû	eyebrow
penêr	cheese
çortan	chortan
şekir	sugar
kevz	moss
henek	joke
xwedê	god
xuda	god
herêm	region
lûr	quail
şikeft	cave
mêrg	meadow
arû	cucumber
şêlim	turnip
sîwan	umbrella
êş	pain
destûr	permission
destpêk	start
derew	lie
çûk	bird
avahî	building
rêwî	traveller
kombers	computer
serşok	bathroom
pênûs	pencil
mêşhingiv	bee
aşpêj	cook
cotyar	farmer
nanpêj	baker
birinc	rice
îlham	inspiration
goştxwer	carnivore
siyaset	politics
hevalî	friendship
ceyran	electricity
peya	man
şemî	saturday
şîranî	dessert
paldank	armchair
qoltix	armchair
sirgûn	exile
çarîne	quatrain
balîna	whale
eylo	eagle
qertel	eagle
bêalîtî	neutrality
çandinî	agriculture
çand	culture
şaxmat	chess
jîn	life
dikak	vegetables
penîr	cheese
perestgeh	temple
pezkûvî	ibex
qesp	dates
milîs	militia
milûk	owner
dêl	tail
tirî	grapes
tişt	thing
tiştanok	riddle
şiwît	dill
şûrik	plow-beam
çayxane	teahouse
werz	season
hirî	wool
hozanvan	poet
jineolojî	jineology
mirîşk	chicken
mişmiş	apricot
qefle	herd
bandev	summit
fistiq	pistachio
sewax	plaster
reqem	digit
jimarnas	mathematician
paşbendik	suffix
dûrbîn	binoculars
destnivîs	manuscript
dirî	thorn
paşnav	surname
ihtiyac	necessity
lazimî	necessity
şikar	hunting
pelîn	wormwood
zencefîl	ginger
rêbendan	january
taran	capital
bexda	baghdad
îran	iran
erîs	eris
rîga	capital
xirvatistan	croatia
swêdî	swedish
dotin	milk
pirsîn	ask
alandin	twist
dîtin	see
hetikandin	embarrass
tirsandin	scare
sekinîn	stay
raketin	sleep
filitîn	escape
jiyan	live
revandin	kidnap
hildan	lift
sekinandin	stop
şewitîn	burn
borandin	forgive
ecibandin	like
xapandin	deceive
mizdan	massage
vexwendin	invite
xemilandin	decorate
nirxandin	assess
şewitandin	burn
jîyan	live
birên	carry
nivîsandin	write
guhartin	change
guherîn	change
cesedî	physical
umêdewar	hopeful
mêwedar	fertile
bêdê	motherless
dijdemokratîk	antidemocratic
فەرەنسی	french
ڕەش	black
پەمبە	pink
پەمبە	magenta
biala	flag-bearer
dihî	yesterday
ستێر	star
piste	pistachio
axil	pen
axil	corral
wert	descendence
qehbe	whore
qehbe	hooker
qehbe	ho
zerk	yolk
riba	interest
sim	hoof
sike	coin
hacat	tool
hacat	implement
hacat	instrument
banyo	bathroom
zang	cave
zang	grotto
vazo	vase
ambasador	ambassador
avdest	abdest
faz	stage
testosteron	testosterone
daşir	toilet
daşir	bathroom
daşir	lavatory
tiwalet	toilet
mewt	death
çekûç	hammer
سێشەم	tuesday
reyîn	bark
rekeh	cage
şampo	shampoo
شامپۆ	shampoo
sefaret	embassy
tilûr	turtledove
tilûr	rook
tilûr	dove
terewîl	bird
zerdelî	apricot
dûkêl	smoke
jûdo	judo
berêkane	competition
hawirkan	competition
riberiz	competition
nûçename	newspaper
kilîd	key
şeftalî	peach
karçîn	pear
navteng	waist
cerah	surgeon
demjimêrk	clock
tenzîlat	sale
tenzîlat	discount
pargîdanî	company
bişir	smile
girrnij	smile
guhnelî	sex
perdaq	glass
bistîk	stalk
çipik	drop
destçep	southpaw
مندار	boy
gêrik	ant
peyarê	pavement
xefnêr	spy
şofar	spy
misabiqe	competition
xilwet	monastery
qire	melon
açar	rye
çexdar	rye
navbendik	infix
kelwaş	statue
kelwaş	body
merhele	stage
esperantoyî	esperanto
qenepe	sofa
mihafize	province
mezad	auction
sinîtî	sunni
kongresman	congressman
reaktor	reactor
janr	genre
derhûd	bondsman
kurtedaw	miniskirt
kurtetenore	miniskirt
ponpeyî	pohnpeian
perestroyka	perestroika
dengiz	sea
پون	henhouse
پون	nest
پنغال	clutch
axpîn	manure
axpîn	filth
axpîn	garbage
گوم	sheepfold
nabos	cul-de-sac
nabos	dead-end
zotik	anus
شرتان	drainpipe
خوپال	pigeon
ایریس	priest
بری	strength
بری	vigour
تورین	nephew
مرابط	nun
meyxanevan	bartender
qepax	lid
balte	axe
zadik	easter
bênavî	namelessness
kîkongoyî	kikongo
netewesazî	nation-building
ferhengvan	lexicographer
binpêker	violator
nexşekêş	mapper
binpêkerî	violation
afirmend	creator
ahengsazî	harmonization
bertîlxwerî	corruption
zirto	braggart
zordarkujî	tyrannicide
zimankujî	linguicide
zimankuj	linguicide
zordarkuj	tyrannicide
dijzanistî	antiscience
xwestok	beggar
xwezanas	naturalist
jêrnivîs	subtitle
tawannasî	criminology
sondname	affidavit
sondxwer	swearer
balexanî	skyscraper
bêfikaretî	recklessness
xewxane	bedroom
pirtûkxanevan	librarian
pirtûkhez	bibliophile
mirovxwer	man-eater
dijwate	antonym
dehsal	decade
givîj	hawthorn
riwekxwer	herbivore
navneteweyîtî	internationalism
neteweyîtî	nationalism
pêşxwarin	starter
nimêjker	prayer
zagonîtî	legality
bêgumanî	doubtlessness
bêencamî	resultlessness
biencamî	resultfulness
bertîlxwer	corrupter
xwelîdank	ashtray
dudeng	diphthong
sîx	pike
prolîn	proline
alanîn	alanine
valîn	valine
trîptofan	tryptophan
anîlîn	aniline
bernameçêker	programer
ketamîn	ketamine
bêwelatî	countrylessness
izin	permission
oksîd	oxide
pentoksîd	pentoxide
hîperoksîd	hyperoxide
peroksîd	peroxide
epoksîd	epoxide
epoksîdasyon	epoxidation
homonîm	homonym
serbixwetî	independence
enîşk	elbow
ڕەنگ	color
ferec	dawn
ferec	daybreak
absans	absence
akronîm	acronym
alegorî	allegory
androlojî	andrology
androtomî	androtomy
fîtotomî	phytotomy
atraksiyon	attraction
anatoksîn	anatoxin
antonîm	antonym
diyoksîn	dioxin
asetenîl	acetenyl
losyon	lotion
retronîm	retronym
jiberxistinkar	abortionist
aktîvîzm	activism
masîzerk	yellowfish
antagonîzm	antagonism
agonîzm	agonism
etnonasyonalîzm	ethnonationalism
kromatîd	chromatid
nefropatî	nephropathy
kardiyolojî	cardiology
mezolojî	mesology
odontolojî	odontology
hîdrometre	hydrometer
hîdroksîd	hydroxide
hîdronyûm	hydronium
klorîn	chlorine
gêjî	dizziness
kêlbetan	tongs
kêlbetan	pincers
inayet	solicitude
camedank	wardrobe
camedank	closet
çekdanîn	armistice
kinif	cannabis
kinif	rope
şadrewan	pool
şadrewan	fountain
çarsem	wednesday
anaxdar	key
çayr	meadow
pêncşemb	thursday
feraş	carpet
zoq	pair
xinamî	in-law
dendrokronolojî	dendrochronology
sûl	waterfall
kisl	lime
frên	brake
bişkur	smile
sêxan	altar
paydos	intermission
paydos	holiday
bayrax	flag
palkursî	armchair
qamûs	dictionary
zarokxane	kindergarten
bastannas	archaeologist
bilgîsayar	computer
çavrî	cattle
çavrî	livestock
çarşev	veil
çarşev	chador
çarşev	fabric
çilm	mucus
çilm	snot
mixenet	traitor
mixdar	quantity
mixdar	amount
qêmîş	mercy
qêmîş	pity
niştîman	homeland
niştîman	fatherland
pixêrîk	hearth
pixêrîk	fireplace
pixêrîk	chimney
qerewil	guard
qerewil	sentinel
qerewil	sentry
mifriq	north
dexalet	refuge
dexalet	asylum
şîlav	pancreas
ferfûr	porcelain
ferfûr	chinaware
ferfûr	faïence
heyşet	town
heyşet	city
hêkesor	easter
hodax	laborer
hodax	worker
hodax	cowherd
hevûrî	billygoat
nerx	price
nerx	value
nerx	worth
tîvil	skin
tîvil	peel
tîvil	rind
seyîs	hostler
seyîs	groom
seyîs	stableman
çîtik	kerchief
domiz	pig
xopanker	saboteur
sefîne	boat
sefîne	ship
sefîne	ark
babirk	sail
baweşînk	fan
qorzî	corner
qorzî	angle
dozgêr	prosecutor
umêd	hope
toq	hoop
toq	circle
toq	necklace
qedûm	feet
qedûm	legs
qedûm	strength
epîgrafî	epigraphy
firrîn	fly
taşandin	educate
cixirandin	incite
sîqilandin	incite
sîqilandin	extinguish
engizandin	incite
belişandin	incite
merixandin	impair
