chipre	island
chipre	and
chipre	country
sardenha	island
sardenha	and
sardenha	region
navarrencs	commune
navarrencs	and
navarrencs	town
que	that
que	which
ensajar	try
ensajar	attempt
cambiar	change
cambiar	modify
crompar	buy
crompar	purchase
alumar	light
alumar	illuminate
daissar	leave
daissar	abandon
laissar	leave
laissar	abandon
arrestar	stop
arrestar	arrest
cessar	stop
cessar	cease
deishar	stop
deishar	leave
restacar	link
restacar	connect
tustar	hit
tustar	strike
entendre	hear
entendre	understand
bastir	build
bastir	construct
aduire	lead
aduire	bring
créisser	increase
créisser	augment
viatjar	travel
viatjar	voyage
adralhar	send
adralhar	transport
aténher	reach
aténher	get
acabar	finish
acabar	complete
començar	begin
començar	start
tocar	touch
tocar	play
abaissar	lower
abaissar	humiliate
agir	act
agir	about
guidar	guide
guidar	lead
abatalhar	attack
abatalhar	assail
respondre	reply
respondre	respond
somiar	dream
somiar	imagine
pantaissar	dream
pantaissar	pant
evidentament	obviously
evidentament	clearly
tuar	kill
tuar	murder
empénher	push
empénher	provoke
vàder	born
vàder	become
asirar	hate
asirar	detest
ronçar	throw
ronçar	precipitate
auçar	rise
auçar	hoist
mestrejar	master
mestrejar	dominate
empachar	prevent
empachar	inhibit
senhar	signal
senhar	indicate
traversar	cross
traversar	traverse
falhir	fail
falhir	err
dever	duty
dever	obligation
acaminar	transport
acaminar	send
frontièra	border
frontièra	frontier
arribar	arrive
arribar	happen
avalir	destroy
avalir	disappear
exactitud	accuracy
exactitud	exactness
camba	leg
camba	stem
eroïna	hero
eroïna	heroine
garison	healing
garison	recovery
engatjar	engage
engatjar	pledge
plorar	cry
plorar	weep
zòna	zone
zòna	area
prèmi	prize
prèmi	award
torneg	tournament
torneg	joust
luchar	combat
luchar	battle
bufar	blow
bufar	gust
coratge	courage
coratge	bravery
pauretat	poverty
pauretat	poorness
guarda	guard
guarda	surveillance
ombra	shade
ombra	shadow
colhonar	joke
colhonar	trick
acabada	achievement
acabada	completion
carn	flesh
carn	meat
molon	stack
molon	heap
muscle	muscle
muscle	mussel
bailejar	organize
bailejar	direct
proa	bow
proa	prow
garir	heal
garir	cure
tet	ceiling
tet	overhead
sosta	shelter
sosta	cover
caçar	hunt
caçar	search
mesa	placement
mesa	placing
enlòc	nowhere
enlòc	anywhere
durada	duration
durada	length
tudèl	pipe
tudèl	tube
gal	cock
gal	rooster
lenga	tongue
lenga	language
capitani	captain
capitani	leader
libertat	liberty
libertat	freedom
cansar	tire
cansar	fatigue
aparelh	apparatus
aparelh	instrument
ongla	nail
ongla	fingernail
rire	laughter
rire	laugh
tesaur	treasure
tesaur	treasury
fendre	divide
fendre	split
plànher	complain
plànher	regret
riba	shore
riba	bank
estanh	pond
estanh	tin
chispa	bitch
chispa	harpy
navegar	navigate
navegar	surf
bestiesa	nonsense
bestiesa	foolishness
entorn	surroundings
entorn	environment
beluga	spark
beluga	flash
ferida	wound
ferida	injury
estatut	statute
estatut	bylaw
cai	dock
cai	quay
refrejar	chill
refrejar	cool
clarièra	clearing
clarièra	glade
pilar	crush
pilar	pulverize
trissar	crush
trissar	pulverize
espotir	crush
espotir	squash
relacion	relation
relacion	relationship
varianta	variant
varianta	variation
amenaçar	threaten
amenaçar	menace
venjança	revenge
venjança	vengeance
anet	duck
anet	dill
cementèri	cemetery
cementèri	graveyard
cementeri	cemetery
cementeri	graveyard
cronomètre	timer
cronomètre	chronometer
empassar	swallow
empassar	ingest
bistèc	steak
bistèc	beefsteak
cridar	shout
cridar	call
masca	witch
masca	mask
esglasiant	terrifying
esglasiant	frightening
sabor	aroma
sabor	flavor
trempar	soak
trempar	wet
suplicar	beg
suplicar	supplicate
esclafar	squash
esclafar	crush
pishar	pee
pishar	piss
sacatjar	sack
sacatjar	pillage
castigar	punish
castigar	castigate
escafar	erase
escafar	remove
bagatge	baggage
bagatge	luggage
vagar	wander
vagar	drift
enterrar	bury
enterrar	inter
auguri	intuition
auguri	foresight
mastegar	chew
mastegar	ruminate
voler	willingness
voler	desire
eschivar	dodge
eschivar	duck
butassar	shove
butassar	push
vinha	vine
vinha	vineyard
congost	canyon
congost	gorge
ataüt	coffin
ataüt	casket
ataüc	coffin
ataüc	casket
hargar	forge
hargar	counterfeit
breçar	cradle
breçar	rock
popa	stern
popa	poop
ponhada	handful
ponhada	fistful
asne	donkey
asne	ass
jovenòt	adolescent
jovenòt	youth
destriar	differentiate
destriar	distinguish
destorbar	hinder
destorbar	obstruct
cresta	crest
cresta	ridge
acrin	crest
acrin	summit
colomb	dove
colomb	pigeon
aborrir	despise
aborrir	detest
susmauta	revolt
susmauta	rebellion
escabòt	troop
escabòt	herd
interrogatòri	interrogation
interrogatòri	questioning
pelha	rag
pelha	skirt
dalfin	dolphin
dalfin	dauphin
manifestacion	manifestation
manifestacion	demonstration
arpa	harp
arpa	claw
tenement	manor
tenement	holdings
ondrar	adorn
ondrar	decorate
pache	pact
pache	agreement
perlongar	prolong
perlongar	extend
rem	rowing
rem	sculling
apasimar	soothe
apasimar	calm
pietat	piety
pietat	pity
traucar	pierce
traucar	hole
niflament	sniffing
niflament	sniffle
pensament	bandage
pensament	worry
ajocar	roost
ajocar	perch
sebelir	inter
sebelir	inhume
aclapar	inter
aclapar	bury
psicòsi	psychosis
psicòsi	hysteria
desfavorable	unfavorable
desfavorable	disadvantageous
reial	regal
reial	royal
calanca	cove
calanca	bay
flòc	flake
flòc	wisp
alongar	lengthen
alongar	elongate
expulsar	eject
expulsar	expel
tremolar	tremble
tremolar	shake
escudet	insignia
escudet	escutcheon
còdol	pebble
còdol	cobble
segada	reaping
segada	harvest
denigrar	belittle
denigrar	denigrate
amaisar	appease
amaisar	soothe
atudar	extinguish
atudar	stop
quequejar	stutter
quequejar	stammer
barca	dinghy
barca	boat
èrm	moor
èrm	wasteland
rema	oar
rema	rowing
firmament	firmament
firmament	heavens
flamenc	flamingo
flamenc	flemish
matrimòni	matrimony
matrimòni	marriage
amora	mulberry
amora	blackberry
tolon	toulon
tolon	tolon
ròse	rhone
ròse	rhône
reticéncia	reticence
reticéncia	reluctance
aubespin	hawthorn
aubespin	whitethorn
joglar	juggler
joglar	jongleur
desvolzar	unroll
desvolzar	insult
padena	imbecile
padena	foolish
izèda	zee
izèda	zed
savòia	savoie
savòia	savoy
timonièr	helmsman
timonièr	coxswain
trenar	plait
trenar	braid
acostumar	accustom
acostumar	habituate
pudent	malodorous
pudent	stinky
cabestran	capstan
cabestran	winch
enfachinar	bewitch
enfachinar	enchant
quilha	skittle
quilha	keel
incomparable	uncomparable
incomparable	incomparable
vulcanologia	volcanology
vulcanologia	vulcanology
castellet	castellet
castellet	commune
castelet	castellet
castelet	commune
focèu	phocaean
focèu	marseillais
global	global
estonian	estonian
liquid	liquid
artificial	artificial
universal	universal
eternal	eternal
insolent	insolent
nuclear	nuclear
tau	such
plan	flat
blau	blue
adjacent	adjacent
public	public
abstrait	abstract
sec	dry
violent	violent
excellent	excellent
fanatic	fanatical
masculin	masculine
evident	evident
oriental	eastern
basic	basic
portable	portable
democratic	democratic
intergalactic	intergalactic
brutal	brutal
metallic	metallic
petit	small
provincial	provincial
italian	italian
platonic	platonic
american	american
occitan	occitan
ignorant	ignorant
bulgar	bulgarian
especial	special
marin	marine
ecologic	ecological
debil	weak
naut	high
doctrinal	doctrinal
traite	traitor
necessari	necessary
paure	poor
fonetic	phonetic
arab	arab
umanitari	humanitarian
parasit	parasitic
universitari	university
rosegaire	rodent
constitucional	constitutional
preliminar	preliminary
espanhòl	spanish
exacte	exact
romanés	romanian
birman	burmese
aisit	easy
benvengut	welcome
comun	common
agil	agile
leugièr	light
lengadocian	languedocian
ongrés	hungarian
darrier	last
actiu	active
excessiu	excessive
brusc	brusque
umil	humble
terapeutic	therapeutic
britanic	british
patriarcal	patriarchal
tancat	closed
centen	hundredth
agressiu	aggressive
silenciós	silent
navèth	new
imaginatiu	imaginative
desconegut	unknown
extraordinari	extraordinary
descriptiu	descriptive
prumier	first
vigorós	vigorous
verdós	greenish
paramilitar	paramilitary
malurous	unhappy
eslovac	slovak
chinés	chinese
mistic	mystical
bielorús	belarusian
multinacional	multinational
seisen	sixth
asiatic	asian
positiu	positive
vièlh	old
òrb	blind
rugós	rough
praube	poor
senèstre	left
esferic	spherical
primièr	first
segond	second
vinten	twentieth
alemand	german
indigèna	indigenous
omosexual	homosexual
màger	major
dobèrt	open
reactiu	reactive
mièg	half
abrasiu	abrasive
cobèrt	covered
biblic	biblical
fallic	phallic
escumós	foamy
estivenc	summer
sistematic	systematic
toristic	touristic
etèrn	eternal
coerent	coherent
meravilhós	marvelous
pirenenc	pyrenean
medish	same
presonèr	imprisoned
dangierós	dangerous
malaisat	difficult
murtrièr	murderous
iberic	iberian
bederrés	béziers
marselhés	marseillais
josieu	jewish
aürós	happy
eroïc	heroic
pa	not
abans	before
absurdament	absurdly
scientificament	scientifically
especialament	especially
finament	finely
nacionalament	nationally
actualament	currently
volontàriament	voluntarily
originalament	originally
tostemps	always
aurá	now
plural	plural
libre	book
color	color
te	tee
o	o
i	i
be	bee
jour	day
país	country
gag	jay
president	president
article	article
art	art
bronze	bronze
jaune	yellow
dia	day
dimension	dimension
paraula	word
continent	continent
actor	actor
ducat	duchy
set	thirst
sang	blood
falcon	falcon
metal	metal
far	lighthouse
fil	thread
electron	electron
u	u
prefix	prefix
panier	basket
mond	world
diccionari	dictionary
mot	word
flor	flower
musica	music
casa	house
neon	neon
argon	argon
zinc	zinc
arsenic	arsenic
fe	faith
maire	mother
pe	pee
television	television
union	union
explosion	explosion
clap	stone
village	village
vent	wind
participant	participant
timbre	timbre
moment	moment
irange	orange
arma	weapon
nos	knot
decision	decision
portal	portal
luna	moon
tor	tower
ren	kidney
pagina	page
pera	pear
gos	dog
ecran	screen
tension	tension
nap	turnip
lua	moon
agricultura	agriculture
lista	list
boisson	bush
dent	tooth
balai	broom
fons	bottom
brand	pitch
det	finger
paire	father
aire	air
bana	horn
balena	whale
mar	sea
professor	teacher
mes	month
favor	favor
abat	abbot
mosca	fly
tè	tea
desastre	disaster
intrada	entrance
espasa	sword
region	region
garganta	throat
pilar	pillar
figa	fig
lop	wolf
lutz	light
mort	death
document	document
mai	may
argent	silver
scientific	scientist
gat	cat
novembre	november
jardin	garden
inclusion	inclusion
persona	person
movement	movement
abril	april
conclusion	conclusion
illa	island
version	version
vin	wine
gran	grain
buc	beehive
secession	secession
prat	meadow
mina	mine
energia	energy
invasion	invasion
soir	evening
fada	fairy
ecologia	ecology
multa	fine
rua	street
enfant	child
campana	bell
potassi	potassium
geografia	geography
teoria	theory
dit	finger
fisica	physics
elefant	elephant
plaça	place
cadena	chain
jornada	day
jota	beet
vida	life
sens	sense
farmacia	pharmacy
cultura	culture
boca	mouth
ordre	order
octobre	october
radi	radium
monument	monument
dolor	pain
confession	confession
cu	cue
maine	domain
nevada	snowfall
calor	heat
planeta	planet
busca	log
dissident	dissident
emission	emission
parlament	parliament
poder	power
fervor	fervor
duc	duke
planta	plant
campion	champion
grama	gram
matin	morning
comte	count
actitud	attitude
bala	bullet
defensa	defense
entrada	entrance
ve	vee
mas	farmhouse
barba	beard
andorran	andorran
galli	gallium
gota	drop
botanica	botany
fluor	fluorine
tibetan	tibetan
esperanto	esperanto
cellula	cell
noga	nut
ji	jay
lach	milk
etimologia	etymology
printemps	spring
sud	south
montanha	mountain
venda	sale
carro	cart
letra	letter
api	celery
gant	glove
tais	badger
pana	breakdown
pega	glue
estrada	road
rit	duck
mur	wall
mont	mount
talpa	mole
malva	mallow
grua	crane
amic	friend
ruda	rue
gost	taste
liti	lithium
metan	methane
cava	cellar
torre	tower
estat	state
escut	shield
liri	lily
fiu	son
aur	gold
ris	rice
mura	wall
cranc	crab
fraga	strawberry
exemple	example
pesada	footprint
interrogator	interrogator
ministre	minister
taca	blot
armonia	harmony
partit	party
branca	branch
bruma	fog
victòria	victory
esperança	hope
oncle	uncle
capitalisme	capitalism
monarca	monarch
ceba	onion
corean	korean
escarabat	beetle
dinamita	dynamite
disciplina	discipline
filtre	filter
excusa	excuse
dentista	dentist
biologia	biology
moja	cistus
nubla	cloud
origina	origin
reforma	reform
vibre	beaver
electrician	electrician
aleta	fin
brot	shoot
abelha	bee
geologia	geology
arqueologia	archaeology
crosta	crust
tron	thunder
germani	germanium
còu	neck
antropologia	anthropology
poesia	poetry
dinastia	dynasty
filosofia	philosophy
piton	python
categoria	category
turc	turkish
pel	hair
artista	artist
ussa	eyebrow
anatomia	anatomy
pan	bread
ostau	house
biografia	biography
astre	luck
vinagre	vinegar
fam	hunger
bruc	heather
geis	plaster
ipocrisia	hypocrisy
ironia	irony
islandés	icelander
danés	danish
compressa	compress
analisi	analysis
tanta	aunt
tecnologia	technology
incendi	fire
ciclista	cyclist
economica	economics
manjar	food
emoglobina	hemoglobin
mitologia	mythology
genetica	genetics
benefici	benefit
urani	uranium
garba	sheaf
proprietari	owner
scientifica	scientist
auton	autumn
uman	human
clau	key
maissa	jaw
genocidi	genocide
fonetica	phonetics
etnia	ethnicity
parlamentari	parliamentarian
musa	muse
faucon	falcon
moisset	falcon
leton	latvian
taula	table
poma	apple
nuèit	night
ostal	house
metallurgia	metallurgy
arna	moth
titani	titanium
ors	bear
mercenari	mercenary
aranha	spider
ciutat	city
estable	stable
filh	son
membre	member
ectara	hectare
adjectiu	adjective
especialista	specialist
fosfat	phosphate
paralisi	paralysis
saba	sap
fea	sheep
polícia	police
algoritme	algorithm
tambor	drum
dinosaure	dinosaur
safran	saffron
faraon	pharaoh
dança	dance
espina	thorn
auca	goose
cotèl	knife
abadiá	abbey
moissal	mosquito
mosquilh	mosquito
vergonha	shame
autisme	autism
arab	arabic
monin	monkey
feda	sheep
braç	arm
caulet	cabbage
comedia	comedy
marqués	marquess
resultat	result
faringe	pharynx
còr	heart
gerba	sheaf
fondacion	foundation
penche	comb
agaça	magpie
menaça	threat
verin	venom
pedagogia	pedagogy
servidor	server
moton	sheep
uèlh	eye
gravitat	gravity
berilli	beryllium
arquitectura	architecture
glaç	ice
electricitat	electricity
atac	attack
geografe	geographer
silici	silicon
formatge	cheese
piada	footprint
tèsta	head
pè	foot
pèira	stone
aurelha	ear
genolh	knee
punh	fist
cavala	mare
èga	mare
sòrre	sister
fraire	brother
trauc	hole
rabàs	badger
assassinat	assassination
nuèch	night
capèl	hat
èrba	grass
sabla	sand
mirga	mouse
ratuga	mouse
solelh	sun
garia	hen
estuari	estuary
coa	tail
manifestant	protester
cigala	cicada
velò	bike
ataca	attack
espion	spy
mandolina	mandolin
impacte	impact
acha	aitch
fascisme	fascism
debat	debate
làmia	shark
morre	snout
polsa	dust
peis	fish
activista	activist
pebre	pepper
gabarra	barge
voltor	vulture
joia	joy
magnitud	magnitude
març	march
agost	august
setembre	september
terrorisme	terrorism
tèrratrem	earthquake
tèrratremol	earthquake
taur	bull
òme	man
socialisme	socialism
palha	straw
preséncia	presence
granolha	frog
castèl	castle
pairin	godfather
mairina	godmother
coide	elbow
espatla	shoulder
ancessor	ancestor
òs	bone
anglés	englishman
pirita	pyrite
sofre	sulfur
conjugason	conjugation
beç	birch
vam	momentum
vilatge	village
frauda	fraud
viatjaire	traveller
lingüista	linguist
fenèstra	window
rossinhòl	nightingale
conilh	rabbit
taupa	mole
singlar	boar
vèrb	verb
guèine	fox
rainal	fox
advèrbi	adverb
preposicion	preposition
lèbre	hare
conjoncion	conjunction
sason	season
colònia	colony
jorn	day
èsser	being
mantèl	coat
ome	man
sassa	bailer
jogador	player
lièch	bed
diluns	monday
dimars	tuesday
dimècres	wednesday
dijòus	thursday
dissabte	saturday
dimenge	sunday
cambiament	change
besson	twin
cagaraula	snail
grèc	greek
dejunar	breakfast
cervesa	beer
mosqueta	mosque
cogombre	cucumber
finesa	fineness
decembre	december
escota	sheet
brica	brick
utilizaire	user
batalha	battle
espiga	spike
tresaur	treasure
biule	poplar
milh	corn
raiç	root
nèu	snow
rugbi	rugby
nèbla	fog
avelana	hazelnut
avelanièr	hazel
fieu	thread
bruèissa	witch
fachilhièra	witch
chalor	heat
monarquia	monarchy
estant	shroud
sorire	smile
pelegrinatge	pilgrimage
societat	society
mocador	handkerchief
sedaç	sieve
robòt	robot
secada	drought
potz	well
imatge	image
pantais	dream
sègle	century
cosina	kitchen
tèrra	earth
fracàs	failure
paur	fear
emocion	emotion
raumàs	cold
gip	plaster
provèrbi	proverb
adieussiatz	goodbye
dinnar	lunch
nívol	cloud
clavèl	nail
chuc	juice
abriu	april
febrièr	february
gèr	january
julhet	july
junh	june
calendièr	calendar
gascon	gascon
lemosin	limousin
auvernhat	auvergnese
ciclon	cyclone
iscla	island
feminista	feminist
tradicion	tradition
qualitat	quality
sicilian	sicilian
activitat	activity
memòria	memory
importància	importance
distància	distance
revirada	translation
bèc	beak
glòria	glory
identitat	identity
escacs	chess
generositat	generosity
feminisme	feminism
caçolet	cassoulet
estornèl	starling
musaranha	shrew
buòu	ox
estudi	study
crompaire	buyer
vendeire	seller
unitat	unity
fabre	smith
gramatica	grammar
abandonament	abandonment
bornhon	beehive
brusc	beehive
fenomèn	phenomenon
volam	sickle
reialme	kingdom
verd	green
basc	basque
bornat	beehive
teulat	roof
teule	roof-tile
murtre	murder
murtrier	murderer
pergam	parchment
amarum	bitterness
eclipsi	eclipse
nacion	nation
escrivan	writer
estela	star
federacion	federation
tractat	treaty
palmon	lung
informacion	information
estudiant	student
universitat	university
erupcion	eruption
setmana	week
cançon	song
cosin	cousin
poton	kiss
càncer	cancer
medecin	doctor
grop	group
situacion	situation
trau	beam
corrent	current
pastís	pastis
districte	district
locutor	speaker
tristesa	sadness
vanadi	vanadium
manganès	manganese
estronci	strontium
azòt	nitrogen
amistat	friendship
camèl	camel
pluèja	rain
exili	exile
devocion	devotion
regim	regime
jornalista	journalist
arribada	arrival
catechisme	catechism
conflicte	conflict
duquessa	duchess
fisician	physicist
extremitat	extremity
milhòc	corn
liech	bed
suve	cork
luec	place
mestierau	artisan
ulhauç	lightning
caissau	molar
vòtz	voice
voutor	vulture
capèu	hat
damatge	damage
campionat	championship
caissal	molar
distorsion	distortion
traïdor	traitor
província	province
comissari	superintendent
jòc	game
èla	el
profecia	prophecy
catalanisme	catalanism
guèrra	war
pòble	people
ventada	wind
civilizacion	civilization
enterrament	burial
dignitat	dignity
ària	air
comunitat	community
arbe	tree
abolicion	abolition
ignorància	ignorance
fugida	flight
alh	garlic
sèrp	snake
riban	ribbon
amorós	lover
glèisa	church
nacionalisme	nationalism
mètge	doctor
feblesa	weakness
ambicion	ambition
immunitat	immunity
perqué	why
courouno	crown
circ	circus
tèms	time
aigo	water
presènço	presence
pensamen	thought
bonur	happiness
qualita	quality
pèrla	pearl
caritat	charity
batèu	boat
campagno	countryside
anhèl	lamb
pastre	shepherd
mistèri	mystery
virginitat	virginity
patz	peace
cardon	thistle
mercat	market
poja	starboard
estalvi	saving
creacion	creation
condicion	condition
generacion	generation
water	toilet
votz	voice
joguet	toy
fèr	iron
cabrit	kid
independentista	independentist
comunicacion	communication
acusacion	accusation
farga	forge
embut	funnel
cantador	singer
aost	august
autar	altar
còrb	raven
escotilha	hatch
gralha	crow
separatisme	separatism
espital	hospital
pergamin	parchment
rasim	grape
cigonha	stork
sabon	soap
tenca	tench
bolon	bolt
distribucion	distribution
chara	face
variacion	variation
fèrre	iron
hèr	iron
determinacion	determination
teorba	theorbo
dominacion	domination
penetracion	penetration
culhièr	spoon
escuma	foam
comunisme	communism
confitura	jam
majofa	strawberry
cerièra	cherry
tija	stem
òrdi	barley
arròda	wheel
ausèth	bird
crocodil	crocodile
gabinet	cabinet
misèria	misery
liuç	lightning
profan	layman
miralh	mirror
rome	blackberry
acadèmia	academy
entitat	entity
torista	tourist
ciclisme	cycling
prosperitat	prosperity
uòu	egg
saviesa	wisdom
diada	day
craba	goat
sciéncia	science
papièr	paper
chaitiu	miserable
messatge	message
òli	oil
còl	neck
mòrt	death
piuse	flea
cervèl	brain
idrogèn	hydrogen
pesolh	louse
desèrt	desert
ròda	wheel
gauta	cheek
julh	july
certesa	certainty
espin	thornbush
faula	fable
escalfament	warming
veitura	car
netejada	cleaning
primavèra	spring
medecina	medicine
mamot	mammoth
imaginacion	imagination
molibdèn	molybdenum
carbòni	carbon
aeropòrt	airport
vèspa	wasp
fabla	fable
alcòl	alcohol
dròlla	girl
filheta	daughterling
bibliotèca	library
gargamèla	throat
miègjorn	midday
mèu	honey
espós	husband
abséncia	absence
bòr	boron
fosfòr	phosphorus
iòde	iodine
plutòni	plutonium
mainada	children
braçalet	bracelet
candèla	candle
minaire	miner
piau	hair
èrsa	swell
torrèla	turret
vèrga	yard
eretic	heretic
poèta	poet
clòr	chlorine
vaisseladoira	dishwasher
accion	action
ficcion	fiction
dalha	scythe
felicitacion	congratulation
posicion	position
mèlsa	spleen
adoracion	adoration
observacion	observation
ablucion	ablution
abdicacion	abdication
microscòpi	microscope
pèrda	loss
besonh	need
excepcion	exception
eliminacion	elimination
perfeccion	perfection
distincion	distinction
lachenca	l
lachuga	lettuce
bledaraba	beet
entrefega	potato
tartifle	potato
tranquillitat	tranquility
serenitat	serenity
palhassa	clown
albricòt	apricot
naissença	birth
suspresa	surprise
emisfèri	hemisphere
explicacion	explanation
pòl	pole
nòrd	north
èst	east
oèst	west
atmosfèra	atmosphere
esfèra	sphere
goja	waitress
acabament	completion
docilitat	docility
passapòrt	passport
trofèu	trophy
desvolopament	development
santat	health
efièch	effect
concèrt	concert
taulièr	workbench
territòri	territory
dialècte	dialect
absurditat	absurdity
preson	prison
observaire	observer
ciutadan	citizen
govèrn	government
publicacion	publication
normalizacion	normalization
electorat	electorate
ambaissador	ambassador
espèra	wait
produccion	production
inondacion	flood
tempèsta	storm
provesiment	provision
famina	famine
violéncia	violence
ròtle	role
destruccion	destruction
arquitècte	architect
atòm	atom
umilitat	humility
arrondiment	arrondissement
sosten	support
cooperacion	cooperation
octòbre	october
mairana	grandmother
independentisme	independentism
minoritat	minority
exòde	exodus
magnèsi	magnesium
cròme	chromium
niquèl	nickel
selèni	selenium
bròme	bromine
zircòni	zirconium
evolucion	evolution
confiscacion	confiscation
lingüistica	linguistics
quimia	chemistry
nautor	height
puèg	hill
armèni	armenian
organizacion	organization
presentacion	presentation
drissa	halyard
batèl	boat
transformacion	transformation
descobèrta	discovery
celebracion	celebration
nòça	wedding
bòrda	farm
espaci	space
tròç	chunk
abdomèn	abdomen
èna	en
esculptor	sculptor
escambi	exchange
èssa	ess
creissença	growth
èu	danewort
dimenjada	weekend
paciéncia	patience
lòna	lagoon
injeccion	injection
desinfectant	disinfectant
ostilitat	hostility
acèr	steel
amelhorament	improvement
beisbòl	baseball
castelhan	castilian
bièrra	beer
corrupcion	corruption
decoracion	decoration
dançaire	dancer
dançaira	dancer
demòni	demon
testimoniatge	testimony
caijuda	fall
espròva	test
divòrci	divorce
conservacion	conservation
duretat	hardness
militarizacion	militarization
educacion	education
egalitat	equality
lançament	launch
disseccion	dissection
eretgia	heresy
erètge	heretic
erètja	heretic
èfa	ef
èrra	ar
eslovèn	slovene
especializacion	specialization
ossamenta	skeleton
establa	stable
eunuc	eunuch
integracion	integration
substitucion	substitution
esséncia	essence
estatistica	statistics
vibracion	vibration
braçat	armful
falanja	phalanx
costèla	rib
engenhaire	engineer
engenhariá	engineering
orfanèl	orphan
orfanèla	orphan
friccion	friction
originalitat	originality
torisme	tourism
fenolh	fennel
fermentacion	fermentation
filantròpa	philanthropist
filosòf	philosopher
filosòfa	philosopher
fisiciana	physicist
supersticion	superstition
prostitucion	prostitution
exageracion	exaggeration
fètus	fetus
paracasudas	parachute
paradòxa	paradox
privatizacion	privatization
dòsi	dose
lèst	ballast
aisina	tool
proprietària	owner
flaüta	flute
marinièr	sailor
guerrièr	warrior
neuròsi	neurosis
enquin	how
invencion	invention
tròba	invention
fondament	foundation
fonèma	phoneme
fotbolaire	footballer
reduccion	reduction
aròma	aroma
ravatge	ravage
gredon	pencil
gèl	ice
sacrilègi	sacrilege
tèrratenent	landowner
mainat	child
reactivitat	reactivity
peish	fish
fusada	rocket
abajon	blueberry
aiganha	dew
navèra	news
jornau	journal
sordat	soldier
garbura	garbure
resson	echo
dalhatge	reaping
arrís	rice
òda	ode
cotèth	knife
huec	fire
fòc	fire
descenta	descent
presoèr	prisoner
presonèr	prisoner
preison	prison
preisonièr	prisoner
neuritud	food
noiriment	food
noiridura	food
uelh	eye
infirmiera	nurse
infirmièra	nurse
infirmièr	nurse
peada	footprint
admiracion	admiration
nuech	night
grossessa	pregnancy
emprenhament	pregnancy
afògament	ardor
aissada	hoe
ponhet	wrist
codonh	quince
terrenh	terrain
anchòia	anchovy
prigondor	depth
brèç	cradle
enfança	childhood
chausida	choice
causida	choice
caumatge	unemployment
mesolha	marrow
cunh	corner
cluèg	thatch
meisson	harvest
telescòpi	telescope
colhon	testicle
talhon	piece
agreu	holly
catedrala	cathedral
umiliacion	humiliation
fauç	sickle
rescontre	encounter
trobairitz	troubadour
margue	handle
ploja	rain
girfalc	gyrfalcon
genibre	juniper
adreiça	address
agrelha	sorrel
faure	blacksmith
fèbre	fever
castèu	castle
chastelan	chatelaine
despiech	spite
despièit	spite
despièch	spite
romec	bramble
sovenença	memory
omenatge	homage
rinocèros	rhinoceros
papautat	papacy
manjadoira	manger
telaranha	spiderweb
modificacion	modification
bureu	office
burèu	office
fautuelh	armchair
fautuèlh	armchair
après-miegjorn	afternoon
après-miègjorn	afternoon
miegjorn	midday
tuaire	killer
murtrièr	murderer
tudelariá	plumbing
idèia	idea
idèa	idea
juguet	toy
leialtat	loyalty
chausa	thing
asard	chance
endoman	morrow
fuelha	leaf
pelegrin	pilgrim
romiu	pilgrim
tristum	sadness
gascona	gascon
oelha	ewe
soninké	soninke
chaul	cabbage
caçairòla	saucepan
artelh	toe
auriò	yellow
dormilhosa	marmot
cambaròt	shrimp
cambajon	ham
lòc	place
josieu	jew
carnivòr	carnivore
molhèr	wife
musèu	museum
dopatge	doping
persec	peach
docha	shower
lengatge	language
avenguda	avenue
chavana	thunderstorm
pairòl	kettle
meteòr	meteor
bossòla	compass
bóstia	box
prudéncia	prudence
quasèrn	notebook
bambó	bamboo
tu	you
eles	they
elas	they
ren	nothing
eres	they
eri	they
nosati	we
soun	his
toun	your
nosautres	we
vosautres	you
quicòm	something
òm	one
aqueste	this
nosates	we
armenia	armenia
argentina	argentina
bulgaria	bulgaria
china	country
cuba	cuba
malta	malta
portugal	portugal
africa	africa
asia	asia
toscana	tuscany
barcelona	province
orleans	orleans
siberia	siberia
america	america
turquia	country
japon	japan
afganistan	afghanistan
can	caen
nil	nile
roan	rouen
guiana	guyenne
ost	village
pomerania	pomerania
aragon	aragon
saragossa	zaragoza
navarra	navarre
frança	france
espanha	spain
irlanda	ireland
islàndia	iceland
bielorussia	belarus
jordania	jordan
canadà	canada
eslovaquia	slovakia
salat	salat
parís	paris
marga	manche
endre	indre
eslovènia	slovenia
índia	india
mexic	mexico
egipte	egypt
galaxia	galaxy
esa	èze
aude	aude
roma	rome
paraguai	country
eua	usa
normandia	normandy
besançon	besançon
polinesia	polynesia
tèrra	earth
bíblia	bible
bessons	gemini
flandes	flanders
pau	pau
escòcia	scotland
grècia	greece
gironda	gironde
medoc	region
bahrayn	bahrain
wikipèdia	wikipedia
jèsus	jesus
euròpa	europe
àustria	austria
austràlia	australia
letònia	latvia
galícia	galicia
provença	provence
mesa	town
marna	marne
cantàbria	cantabria
char	cher
cruesa	creuse
erau	hérault
losera	lozère
òlt	lot
anglatèrra	england
piemont	piedmont
borges	bourges
soïssa	switzerland
valença	valence
zoroastre	zoroaster
campània	campania
sevilha	seville
diu	god
belgica	belgium
ais	aix-en-provence
andòrra	andorra
ongria	hungary
luxemborg	luxembourg
catalonha	catalonia
mónegue	monaco
polonha	poland
angòla	angola
ardenas	department
canas	cannes
pèrsia	persia
carcassona	carcassonne
nimes	nîmes
costa	costa
baiona	bayonne
calàbria	calabria
botan	bhutan
danemarc	denmark
peró	peru
artigas	artigues
casals	village
montalban	montauban
veneçuèla	country
espanh	spain
pèire	peter
bucarèst	bucharest
gènoa	genoa
gasconha	gascony
droma	drôme
calvadòs	calvados
arièja	ariège
alèir	allier
aups	alps
avairon	aveyron
charanta	charente
dordonha	dordogne
maiòta	mayotte
corsega	corsica
guadalope	guadeloupe
léger	loire
reünion	réunion
sòna	saône
vinhana	vienne
pirenèus	pyrenees
sèina	seine
lanas	landes
mosèla	moselle
mòsa	meuse
nòrd	nord
vauclusa	vaucluse
vendèa	vendée
perpinhan	perpignan
marròc	morocco
paquistan	pakistan
genèva	geneva
colómbia	country
iemèn	yemen
limòtges	limoges
lemòtges	limoges
bigòrra	bigorre
corèa	korea
arrienh	village
arnhac	village
artigues	village
arrot	village
cadilhac	cadillac
montpelhièr	montpellier
grenòble	grenoble
angieus	angers
brèst	brest
amians	amiens
nancí	nancy
dunquèrca	dunkirk
versalhas	versailles
antíbol	antibes
besièrs	béziers
merinhac	mérignac
peçac	pessac
tròias	troyes
chamberí	chambéry
niòrt	niort
argeria	algeria
nigèr	niger
moscòu	moscow
malhòrca	majorca
andalosia	andalusia
lhèida	lleida
massat	town
brageirac	bergerac
coseran	couserans
coserans	couserans
shoantenh	village
unzent	village
telhet	village
cotens	village
coflens	village
criu	village
dalon	village
daumasan	village
menòrca	minorca
perigòrd	périgord
peiregòrd	périgord
peiriguers	périgueux
periguers	périgueux
peishs	pisces
bòsols	city
bossòst	bossòst
mirèio	mireille
miglòs	village
samotràcia	samothrace
zèus	zeus
nerac	city
betleèm	city
betsabèa	bathsheba
cadiç	city
engolesme	city
engoleime	city
rosselhon	roussillon
larache	city
carcin	quercy
carmaus	carmaux
carmauç	carmaux
urau	village
comenge	comminges
malagoda	village
malleon	village
madièra	village
mansas	village
sèish	village
montoliu	village
santenh	village
montferrièr	village
montgalhard	village
montgaug	village
sorjat	village
rasés	region
arpajon	city
arpavon	village
ascon	village
eissalabra	chalabre
najac	village
conhac	cognac
abandonar	abandon
cantar	sing
caber	fit
plaire	please
mandar	send
scribe	write
vendre	sell
prendre	take
volar	fly
venir	come
descendre	descend
utilizar	use
exigir	demand
justificar	justify
nadar	swim
vader	go
har	make
voler	want
mostrar	show
comprendre	understand
presentar	present
decidir	decide
participar	participate
organizar	organize
explicar	explain
atacar	attack
considerar	consider
votar	vote
armar	arm
representar	represent
salvar	save
determinar	determine
activar	activate
combinar	combine
dividir	divide
lavar	wash
cavar	dig
roncar	snore
pagar	pay
girar	turn
pendre	hang
costar	cost
pintar	paint
jogar	play
posar	draw
marchar	march
abdicar	abdicate
actualizar	update
administrar	administer
distinguir	distinguish
escupir	spit
detectar	detect
divorciar	divorce
eliminar	eliminate
excusar	excuse
ignorar	ignore
imaginar	imagine
manipular	manipulate
tapar	cork
virar	turn
confinar	confine
pegar	glue
desarmar	disarm
desinfectar	disinfect
escalfar	heat
espetar	explode
estofar	choke
evaporar	evaporate
fertilizar	fertilize
filmar	film
minar	mine
preservar	preserve
prosperar	prosper
salar	salt
tornar	return
nevar	snow
brandar	burn
manjar	eat
practicar	practise
pujar	ascend
localizar	locate
fabricar	manufacture
corregir	correct
ligar	bind
manifestar	protest
parlar	speak
abreujar	shorten
verificar	verify
forçar	force
brilhar	shine
comunicar	communicate
distraire	distract
segar	harvest
cronometrar	time
aprendre	learn
escriure	write
viure	live
cobrir	cover
estacar	attach
dançar	dance
passejar	walk
tronar	thunder
colonizar	colonize
especializar	specialize
generalizar	generalize
conjugar	conjugate
criticar	criticize
assumir	assume
engolir	swallow
baratar	barter
corrompre	corrupt
gardar	protect
fadar	bewitch
evolucionar	evolve
caler	necessary
alternar	alternate
amagar	hide
plegar	fold
divulgar	divulge
sopar	dine
veire	see
abocar	pour
divisar	divide
brandir	brandish
trobar	find
eissugar	wipe
aprestar	prepare
sovenir	remember
establir	establish
fondar	found
creire	believe
afichar	show
acompanhar	accompany
demembrar	forget
legir	read
reconéisser	recognize
rasar	shave
recebre	receive
voidar	empty
véser	see
vojar	empty
tòrcer	twist
tampar	close
dobrir	open
tafurar	worry
subreviure	survive
soscar	think
simplificar	simplify
siblar	whistle
senhalar	signal
sedaçar	sieve
saupre	know
sautar	jump
saunejar	dream
saquejar	shake
sagelar	seal
ríser	laugh
rondinar	grumble
reveire	review
resòlvre	resolve
resòlver	resolve
restancar	stop
ressegar	saw
rescondre	hide
raubar	steal
quilhar	erect
quichar	press
pénher	paint
porgir	supply
popar	suckle
polsar	breathe
poirir	rot
partejar	share
nhacar	bite
netejar	clean
mólzer	milk
muishar	show
mesclar	mix
mentàver	mention
manlevar	borrow
lisar	slide
jónher	join
intrar	enter
fénher	feign
fregir	fry
fracassar	fail
fissar	sting
fiular	whistle
còire	cook
esternudar	sneeze
estalviar	save
estraçar	tear
esquinçar	tear
esplechar	harvest
espaventar	terrify
escantir	stop
esbolhar	disembowel
entornejar	surround
enrodar	surround
enebir	forbid
endevinar	guess
emplenar	fill
empegar	glue
dòlre	hurt
bolegar	move
dintrar	enter
devinar	guess
desvolopar	develop
delembrar	forget
davalar	descend
càser	fall
cóser	sew
càder	fall
crénher	fear
créser	believe
créder	believe
conéisher	know
conéisser	know
conóisser	know
colcar	rest
clavelar	nail
caupre	fit
caufar	heat
capitar	succeed
capolar	mince
calfar	heat
caire	fall
cabussar	dive
butar	push
brembar	remember
bronzinar	buzz
barrutlar	wander
barrejar	mix
balhar	give
bandir	throw
balajar	sweep
lançar	throw
desfar	undo
ausir	hear
aturar	stop
assostar	protect
assetjar	besiege
assanar	sanitize
assabentar	inform
asaigar	water
arríder	laugh
asclar	cleave
arroïnar	ruin
arreconéisher	recognize
apréner	learn
arpar	claw
aprigondir	deepen
apondre	add
aparéisser	appear
aparéisher	appear
ancorar	anchor
finançar	finance
alenar	breathe
alachar	breastfeed
afogar	alight
acocolar	squat
acceptar	accept
encoratjar	encourage
defendre	defend
lecar	lick
sejar	saw
cometre	commit
reduire	reduce
jutjar	judge
protegir	protect
refusar	refuse
daurar	gild
enfonsar	sink
abitar	inhabit
injectar	inject
ofrir	offer
tochar	touch
privatizar	privatize
rintrar	reenter
favorir	favor
assistir	attend
confessar	confess
accentuar	accentuate
rovilhar	rust
encarcerar	incarcerate
afavorir	favor
umiliar	humiliate
capvirar	capsize
sonsir	sink
defugir	avoid
collaborar	collaborate
contunhar	continue
ensenhar	teach
amelhorar	improve
impausar	impose
promòure	promote
remplaçar	replace
esperlongar	prolong
espitalizar	hospitalize
graciar	pardon
eretar	inherit
excellir	excel
crentar	fear
potonar	kiss
tribalhar	work
bohar	blow
noirir	feed
devarar	descend
còser	cook
chausir	choose
rescontrar	encounter
júnher	join
auvir	hear
acasar	marry
bevetar	sip
comprener	understand
compréner	understand
prener	take
chamjar	change
solatjar	relieve
exuberant	exuberant
corruptible	corruptible
marsian	martian
bèll	beautiful
pluricultural	multicultural
charman	charming
vanitós	vain
degourdit	streetwise
sagaç	wise
sagaç	sagacious
matader	deadly
sèxt	sixth
omofòbe	homophobic
sinceramen	sincerely
tranquilamen	serenely
tranquilamen	tranquilly
urosadament	fortunately
cafe	coffee
cafe	café
fount	spring
fount	fountain
semano	week
naturo	nature
coronavirus	coronavirus
scalo	stairs
tacha	blot
laga	wake
polacre	foresail
polacre	jib
cabeça	head
cabeça	mind
cabeça	plough
caloria	calorie
espino	thorn
infirmier	nurse
chambro	bedroom
ixa	ex
catin	puppet
crompaira	buyer
creaturo	creature
favolha	crab
badau	onlooker
fablo	fable
nèbia	fog
nèbia	mist
straa	road
tristesso	sadness
garçoun	boy
reglamen	rule
reglamen	regulation
reglamen	law
enterramen	burial
douctour	doctor
pagamen	payment
oumbro	shade
poèto	poet
rèpublico	republic
autouno	fall
autouno	autumn
pourtrèt	portrait
mauga	mallow
moutoun	sheep
cocombre	cucumber
rat-vibre	coypu
colombre	cucumber
bastilha	castle
bastilha	fortress
salmoira	brine
vendeta	vendetta
darbon	mole
reba	wayfaring-tree
codombre	cucumber
angròla	lizard
pèstel	cleat
aucièra	hawser
aurassa	hurricane
matafion	lash
òrsa	port
òrsa	larboard
fenestreta	porthole
maréa	tide
lavavaissèla	dishwasher
lavavaishèra	dishwasher
caprifuèlh	honeysuckle
bronquioscopia	bronchoscopy
estetoscòpi	stethoscope
lachairon	l
bocinhòla	potato
perilha	potato
tomaquet	tomato
estomaguet	tomato
marcejada	downpour
encarceracion	imprisonment
encarceracion	incarceration
soulè	attic
secaresso	drought
gairoton	lupin
gairoton	lupine
bilhon	lupin
bilhon	lupine
bilhon	vetch
agoust	august
bourdegas	kid
sampa	puddle
èvol	danewort
èusses	danewort
èules	danewort
èule	danewort
èufe	danewort
trauguen	gudgeon
vitauguèra	honeysuckle
electriciana	electrician
merlet	merlon
èma	em
bartavèla	latch
exuberància	exuberance
prolixitat	prolixity
bouffo	mole
bèsto	jacket
melanòma	melanoma
letruda	bluestocking
indocilitat	indocility
husada	rocket
anolha	heifer
bagnaduro	moisture
bagnaduro	dew
brevitat	brevity
matader	slaughterhouse
hoec	fire
niflal	sniffing
niflal	sniffle
delectacion	delectation
codèrc	pasture
codèrc	meadow
codèrc	enclosure
dindola	jujube
travès	outside
travès	width
jauta	cheek
netiatge	cleaning
sufrença	suffering
sufrença	pain
poteu	post
poteu	pole
becana	bike
adiussiatz	goodbye
amontanhatge	transhumance
goelha	ewe
khassonké	khassonké
dgenné	jinn
dgenné	genie
parpalhòu	butterfly
parpalhòu	cunt
parpalhòu	pussy
parpalhòt	protestant
liquossiana	potion
catisson	puppet
anajon	blueberry
batifòc	lighter
gatet	kitten
gatet	kitty
bavec	chatterbox
bavec	talker
saurra	sand
saurra	ballast
boscàs	forest
pompéia	pompeii
mefistofeles	mephistopheles
croquièr	village
druèlha	village
meiruèis	village
pèirahorada	peyrehorade
milglòs	village
nourjat	norgeat
franquenstein	frankenstein
polux	pollux
montfà	village
ponchar	sting
profanar	profane
desmentir	deny
desmentir	refute
militarizar	militarize
abraçar	embrace
abraçar	hug
conglaçar	freeze
salinizar	salinize
romiar	chew
romiar	ruminate
romiar	consider
robotizar	robotize
robotizar	robotise
robotizar	roboticize
respalmar	bounce
respalmar	rebound
rabinar	burn
rabejar	soak
rabejar	bathe
rabastinar	burn
paralisar	paralyze
peçugar	pinch
petejar	sparkle
pecigar	pinch
lausenjar	laud
lausenjar	praise
subrenadar	float
esventrar	disembowel
estripar	disembowel
espavordir	scare
espavordir	scared
engeissar	plaster
dardalhar	radiate
chabar	finish
carcanhar	worry
cantorlejar	hum
bassacar	ransack
bassacar	pillage
bartavelar	chat
bartavelar	chatter
assegutar	pursue
alaitar	breastfeed
abonaçar	calm
abonir	improve
abautir	falter
abautir	stumble
abauquir	grass
abaucar	appease
abastardir	spoil
abastardir	worsen
abastardir	degrade
abasar	demolish
abarrejar	mix
abadalhar	open
desplaire	displease
fornejar	bake
abandounar	abandon
abandounar	leave
toumbar	fall
enquietar	worry
sucar	suck
enforcar	mount
piquar	ring
piquar	knock
piquar	strike
illegalizar	illegalize
illegalizar	illegalise
illegalizar	outlaw
espionar	spy
fraudar	defraud
denudar	undress
denudar	denude
entristesir	sadden
endemoniar	bedevil
arrincar	uproot
somniar	dream
embroishir	bewitch
desembroishir	disenchant
potoar	kiss
rogesir	redden
rogesir	blush
desmalholar	unswathe
desmalholar	unswaddle
malholar	swathe
malholar	swaddle
gachar	look
gachar	watch
ablanquir	whiten
ablanquir	bleach
ablanquir	whitewash
agrepir	dull
ajúnher	adjoin
acalhaudar	stone
rudejar	mistreat
desendemoniar	disenchant
planher	complain
interrojar	interrogate
risolar	laugh
ronflar	snore
