jamajka	island
jamajka	and
jamajka	country
moči	can
moči	able
rabiti	use
rabiti	need
poskušati	try
poskušati	attempt
poskusiti	try
poskusiti	attempt
morati	must
morati	have
uživati	enjoy
uživati	consume
basati	stuff
basati	cram
amerika	america
amerika	country
peljati	drive
peljati	lead
iskati	search
iskati	seek
pasti	fall
pasti	graze
padati	fall
padati	drop
seči	reach
seči	cut
začeti	begin
začeti	start
aktualizirati	update
aktualizirati	actualize
posodobiti	update
posodobiti	modernize
evropa	europe
evropa	europa
mraz	cold
mraz	frost
izraz	term
izraz	expression
tema	dark
tema	darkness
spol	sex
spol	gender
mešati	mix
mešati	confuse
karta	map
karta	card
darovati	gift
darovati	sacrifice
odločba	rule
odločba	order
ločevati	separate
ločevati	distinguish
zdravnik	doctor
zdravnik	physician
pritisk	pressure
pritisk	strain
telovaditi	exercise
telovaditi	train
pisatelj	writer
pisatelj	author
ravnotežje	balance
ravnotežje	equilibrium
naravnost	straight
naravnost	exactly
lestvica	straight
lestvica	charts
kitajec	chinese
kitajec	chinaman
zagnati	launch
zagnati	start
skala	rock
skala	scale
vzhod	rise
vzhod	east
vzpon	rise
vzpon	ascent
razgovor	conversation
razgovor	talk
pogovor	conversation
pogovor	talk
ženska	female
ženska	woman
sodnik	judge
sodnik	referee
govor	speech
govor	talk
predlagati	suggest
predlagati	propose
križ	cross
križ	♣
menjati	exchange
menjati	swap
meso	meat
meso	flesh
obrazilo	element
obrazilo	desinence
krožnik	plate
krožnik	dish
pravičnost	justice
pravičnost	fairness
kamion	truck
kamion	lorry
konj	horse
konj	knight
vključiti	enable
vključiti	include
nogomet	football
nogomet	soccer
bogastvo	wealth
bogastvo	fortune
priznati	admit
priznati	acknowledge
sreča	luck
sreča	happiness
dama	lady
dama	queen
smeh	laugh
smeh	laughter
nebesa	heaven
nebesa	sky
klobuk	hat
klobuk	cap
goreti	burn
goreti	blaze
val	wave
val	undulation
rit	ass
rit	asshole
pamet	intelligence
pamet	sense
cona	zone
cona	area
prebivalec	resident
prebivalec	inhabitant
človeštvo	humanity
človeštvo	mankind
profesor	professor
profesor	teacher
roža	flower
roža	rose
krasti	steal
krasti	sneak
med	honey
med	brass
nesreča	accident
nesreča	misfortune
tvorba	formation
tvorba	creation
kot	angle
kot	corner
slava	glory
slava	fame
tekočina	fluid
tekočina	liquid
klop	bench
klop	tick
portfelj	portfolio
portfelj	briefcase
vleči	drag
vleči	draw
očala	glasses
očala	spectacles
božati	stroke
božati	caress
pipa	tap
pipa	faucet
ser	grey
ser	gray
drag	dear
drag	expensive
sladkarija	candy
sladkarija	sweet
slaščica	candy
slaščica	sweet
vreden	worthy
vreden	valuable
krilo	skirt
krilo	wing
carstvo	kingdom
carstvo	tsardom
čustvo	emotion
čustvo	feeling
načeti	slice
načeti	begin
jezik	tongue
jezik	language
grad	castle
grad	city
matica	queen
matica	nut
brskati	dig
brskati	browse
žal	grief
žal	sorrow
utrujati	tire
utrujati	exhaust
gravitacija	gravity
gravitacija	gravitation
pomočnik	assistant
pomočnik	wizard
slabo	badly
slabo	poorly
zadovoljiti	satisfy
zadovoljiti	fulfill
zadovoljevati	satisfy
zadovoljevati	fulfill
gros	gross
gros	144
jesen	autumn
jesen	fall
hlev	barn
hlev	cowshed
zadnjica	butt
zadnjica	buttocks
meter	meter
meter	metre
rana	wound
rana	injury
objem	hug
objem	embrace
puška	rifle
puška	gun
hrbtenica	spine
hrbtenica	backbone
tekač	runner
tekač	bishop
toga	sadness
toga	toga
drog	pole
drog	stick
gospa	mrs
gospa	lady
viza	visa
viza	beluga
oreh	nut
oreh	walnut
ducat	dozen
ducat	12
pluti	sail
pluti	float
megla	fog
megla	mist
gripa	flu
gripa	influenza
sum	suspicion
sum	mistrust
ded	grandfather
ded	ancestor
kozel	goat
kozel	fool
skorja	bark
skorja	crust
lopov	thief
lopov	crook
brada	beard
brada	chin
žila	vein
žila	sinew
lice	cheek
lice	face
bor	pine
bor	boron
sperma	sperm
sperma	semen
izpeljanka	derivative
izpeljanka	derivation
črv	worm
črv	maggot
madžarski	hungarian
madžarski	magyar
madžarka	hungarian
madžarka	magyar
striči	shave
striči	shear
kup	heap
kup	pile
hosta	scrub
hosta	forest
čelo	forehead
čelo	cello
goba	mushroom
goba	sponge
strok	pod
strok	husk
smrtonosen	lethal
smrtonosen	deadly
želva	turtle
želva	tortoise
kit	whale
kit	putty
objaviti	proclaim
objaviti	issue
koder	curl
koder	poodle
trdnjava	fortress
trdnjava	rook
elektron	electron
elektron	electrum
nadlegovati	disturb
nadlegovati	bother
škofija	diocese
škofija	bishopric
neplodnost	infertility
neplodnost	sterility
bradavica	nipple
bradavica	wart
povest	novella
povest	history
ezra	ezra
ezra	esdras
nuna	nun
nuna	sister
babica	midwife
babica	grandmother
delfin	dolphin
delfin	butterfly
los	elk
los	moose
enorog	unicorn
enorog	narwhal
kopati	bathe
kopati	dig
deva	maiden
deva	virgin
izdati	betray
izdati	publish
kmet	peasant
kmet	pawn
kositi	mow
kositi	scythe
krma	fodder
krma	stern
dajalec	giver
dajalec	donor
zajec	hare
zajec	rabbit
slovak	slovak
slovak	slovakian
knjigarna	bookshop
knjigarna	bookstore
skriven	clandestine
skriven	hidden
vran	raven
vran	crow
sečnica	urethra
sečnica	secant
klošar	tramp
klošar	vagrant
uplinjač	carburetor
uplinjač	carburettor
mačeha	stepmother
mačeha	pansy
lama	llama
lama	lama
milimeter	millimeter
milimeter	millimetre
števnik	numeral
števnik	number
panj	beehive
panj	treestump
kilometer	kilometre
kilometer	kilometer
fazan	pheasant
fazan	freshman
jastreb	vulture
jastreb	hawk
drkati	wank
drkati	masturbate
melancana	aubergine
melancana	eggplant
izsiljevalski	blackmailing
izsiljevalski	extortionary
glasoslovje	phonology
glasoslovje	phonetics
rastlinojedec	herbivore
rastlinojedec	vegetarian
slovenščina	slovene
slovenščina	slovenian
slovenka	slovene
slovenka	slovenian
slovenec	slovene
slovenec	slovenian
ravnost	evenness
ravnost	levelness
čajnica	teahouse
čajnica	tearoom
kuna	marten
kuna	kuna
hematologija	haematology
hematologija	hematology
strešica	circumflex
strešica	háček
jamar	caver
jamar	spelunker
grozdje	raceme
grozdje	cluster
kozorog	capricornus
kozorog	capricorn
oje	thill
oje	shaft
hidžra	hegira
hidžra	hijra
hektoliter	hectoliter
hektoliter	hectolitre
oman	inula
oman	elecampane
bel	white
nagel	fast
ruski	russian
danski	danish
žolt	yellow
slep	blind
temen	dark
oster	sharp
smel	bold
svetel	bright
betežen	feeble
atomski	atomic
strupen	toxic
krut	cruel
splošen	general
črn	black
šesti	sixth
vroč	hot
mrtev	dead
ameriški	american
zlomljen	broken
naraven	natural
jezen	angry
okrogel	round
sodoben	contemporary
katalonski	catalan
mitološki	mythological
dolgočasen	boring
kovinski	metal
oseben	personal
pornografski	pornographic
glagolski	verbal
samostalniški	substantival
nepotrpežljiv	impatient
strasten	passionate
jordanski	jordanian
bivši	former
gruzinski	georgian
podoben	similar
sinhron	synchronous
izglagolski	deverbative
prvoten	original
zahoden	western
južen	southern
dovršen	perfective
bar	otherwise
bruto	gross
spet	again
zmeraj	always
bolgarsko	bulgarian
češko	czech
angleško	english
finsko	finnish
madžarsko	hungarian
irsko	irish
italijansko	italian
norveško	norwegian
že	already
včeraj	yesterday
takoj	immediately
zgodaj	early
kje	where
najbolj	most
posebej	especially
enkrat	once
robot	robot
planet	planet
most	bridge
last	property
general	general
dar	gift
tiger	tiger
pi	pi
sol	salt
zebra	zebra
as	ace
car	tsar
del	part
bran	defense
angel	angel
zima	winter
led	ice
let	flight
met	throw
bog	god
sin	son
sit	rush
penis	penis
nit	thread
file	fillet
las	hair
sir	cheese
cesta	road
neon	neon
radon	radon
ol	beer
titan	titanium
baba	hag
bar	bar
vid	eyesight
pianist	pianist
sel	messenger
bask	basque
kava	coffee
roman	novel
poker	poker
log	grove
lug	lye
rosa	dew
zona	shudder
rad	gladness
nos	nose
pero	feather
luna	moon
bon	voucher
dom	home
zet	son-in-law
stol	chair
lira	lyre
sobota	saturday
dan	day
oven	ram
hotel	hotel
lok	bow
vino	wine
pest	fist
sestra	sister
kura	hen
hruška	pear
liter	litre
duda	pacifier
palimpsest	palimpsest
peta	heel
maj	may
ulica	street
vnuk	grandson
metla	broom
žena	wife
sever	north
žaba	frog
žirafa	giraffe
malina	raspberry
koza	goat
kenguru	kangaroo
slon	elephant
palindrom	palindrome
vice	purgatory
amulet	amulet
dude	bagpipes
les	wood
kitara	guitar
kondom	condom
past	trap
vagina	vagina
paladin	paladin
insekt	insect
krst	baptism
krava	cow
vrana	crow
koža	skin
fotograf	photographer
pes	dog
cigareta	cigarette
cigara	cigar
zrak	air
vojna	war
matematika	mathematics
sendvič	sandwich
baker	copper
voda	water
okno	window
pod	floor
buldog	bulldog
banka	bank
jak	yak
hip	moment
pentagram	pentagram
oko	eye
čaj	tea
vest	conscience
primer	example
plug	plough
cena	price
pila	file
figa	fig
hadron	hadron
holm	hill
mir	peace
pica	pizza
rep	tail
sod	barrel
tat	thief
slap	waterfall
vile	pitchfork
sonce	sun
tip	type
odrešenik	messiah
seks	sex
motor	engine
post	fast
sila	force
ananas	pineapple
jug	south
puma	puma
pita	pie
volfram	tungsten
fagot	bassoon
pena	foam
hrana	food
bas	bass
gol	goal
glas	voice
januar	january
februar	february
trot	drone
kalij	potassium
ud	limb
vas	village
vol	ox
meta	mint
slop	pillar
uran	uranium
medicina	medicine
diamant	diamond
simbol	symbol
oznaka	mark
lešnik	hazelnut
leto	year
kila	hernia
oblak	cloud
igra	play
avgust	august
sreda	wednesday
nedelja	sunday
množina	plural
vojvodina	duchy
butan	butane
lakota	hunger
rog	horn
april	april
september	september
november	november
december	december
piramida	pyramid
kras	karst
jod	iodine
reka	river
minuta	minute
islam	islam
ime	name
kvadrat	square
zvezda	star
stvar	thing
jež	hedgehog
zver	beast
strela	lightning
koledž	college
jagnje	lamb
jagnjetina	lamb
papir	paper
streha	roof
vinograd	vineyard
borovnica	blueberry
pivo	beer
balet	ballet
umetnik	artist
veverica	squirrel
runo	fleece
katedrala	cathedral
sok	juice
jutro	morning
kol	stake
albanka	albanian
klavir	piano
krom	chromium
ptica	bird
religija	religion
greh	sin
zaliv	bay
trava	grass
nota	note
glagol	verb
dolg	debt
košarka	basketball
plod	fruit
kontinent	continent
nož	knife
strah	fear
vaza	vase
zlato	gold
etimologija	etymology
mamut	mammoth
zid	wall
knjiga	book
čaša	cup
ogledalo	mirror
pšenica	wheat
lepota	beauty
kop	hoe
masa	mass
liga	league
palma	palm
duh	ghost
prod	pebbles
helij	helium
litij	lithium
berilij	beryllium
princesa	princess
modo	testicle
dno	bottom
pav	peacock
boginja	goddess
plamen	flame
brod	ford
iskra	spark
teta	aunt
deber	gorge
heraldika	heraldry
vidra	otter
vitez	knight
skakač	knight
večer	evening
fluor	fluorine
rama	shoulder
musliman	muslim
harmonika	accordion
pingvin	penguin
motika	hoe
oaza	oasis
pustinja	desert
liturgija	liturgy
bakla	torch
železo	iron
riba	fish
klas	ear
vogal	corner
govno	shit
sranje	bullshit
platina	platinum
zmaj	dragon
dušik	nitrogen
vodik	hydrogen
limonada	lemonade
sultan	sultan
mujezin	muezzin
polje	field
odgovor	answer
dlaka	hair
gora	mountain
zaimek	pronoun
aligator	alligator
smrt	death
nindža	ninja
republika	republic
javor	maple
obraz	face
rasa	race
grah	pea
priča	witness
mleko	milk
mreža	net
hvala	praise
dob	oak
urok	spell
rima	rhyme
soba	room
lom	fracture
kocka	die
kis	vinegar
tele	calf
igo	yoke
seno	hay
medved	bear
armada	army
zora	dawn
mak	poppy
uho	ear
kino	cinema
epicenter	epicentre
nič	nothing
tisoč	thousand
lev	lion
denar	money
kupa	beaker
fosfor	phosphorus
pira	spelt
glava	head
roka	hand
glina	clay
sliva	plum
ksenon	xenon
usta	mouth
pokol	massacre
vihar	storm
pust	lent
ruda	ore
beseda	word
mati	mother
sneg	snow
vedro	bucket
čast	honour
ukaz	order
solza	tear
bolha	flea
zastava	flag
moka	flour
krog	circle
čoln	boat
lep	glue
sosed	neighbour
testo	dough
gost	guest
ščet	brush
igla	needle
sidro	anchor
brana	harrow
briga	care
muha	fly
grob	grave
kokoš	hen
lim	elm
losos	salmon
polica	shelf
rast	growth
svoboda	freedom
volna	wool
zob	tooth
telo	body
brlog	lair
brazda	furrow
jabolko	apple
mula	mule
telur	tellurium
krap	carp
opica	monkey
grablje	rake
kamin	fireplace
rešeto	sieve
ključ	key
gnoj	pus
grba	hump
volja	will
vreme	weather
misel	thought
golt	throat
stolp	tower
smetana	cream
biser	pearl
bezeg	elder
bivol	buffalo
čipka	lace
deska	board
dijak	student
gozd	forest
gorica	hill
grapa	ditch
gumb	button
kad	tub
klobasa	sausage
kostanj	chestnut
kovač	smith
košara	basket
koš	basket
kruh	bread
kvas	yeast
ladja	ship
lemež	plough-share
vraža	superstition
vrša	fish-trap
medenica	pelvis
mlin	mill
mesar	butcher
orel	eagle
orjak	giant
otok	island
pajek	spider
pastir	shepherd
pečat	seal
pekel	hell
pepel	ashes
petek	friday
pijavka	leech
pleva	chaff
podgana	rat
pogača	cake
posel	mission
prestol	throne
slanina	bacon
sloka	snipe
tovariš	comrade
praprot	fern
rek	speech
sladkor	sugar
smet	sweepings
ščuka	pike
hči	daughter
zober	bison
ris	lynx
srp	sickle
raca	duck
policija	police
granica	border
juha	soup
bič	whip
esej	essay
grk	greek
beton	concrete
krater	crater
slovar	dictionary
bron	bronze
arhitektura	architecture
parfum	perfume
mangan	manganese
češplja	plum
ogenj	fire
zgodovina	history
perut	wing
atol	atoll
brusnica	lingonberry
bolnica	hospital
hrošč	beetle
narval	narwhal
panteon	pantheon
uniforma	uniform
veja	branch
erbij	erbium
prepustnica	pass
kvark	quark
turkinja	turk
vulkan	volcano
ognjenik	volcano
malarija	malaria
geologija	geology
svila	silk
mulj	silt
temperatura	temperature
kladivo	hammer
nlp	ufo
piton	python
alkohol	alcohol
meč	sword
filozof	philosopher
vlak	train
antimon	antimony
tapeta	wallpaper
bizon	bison
prostata	prostate
apostrof	apostrophe
sonatina	sonatina
klitoris	clitoris
anakonda	anaconda
funt	pound
amper	ampere
milo	soap
ječmen	barley
oves	oat
jezero	lake
koleno	knee
bik	bull
vrabec	sparrow
breza	birch
vampir	vampire
palec	thumb
adut	trump
agrumi	citrus
bager	dredge
barka	boat
bedak	fool
bergla	crutch
bizgec	fool
bokal	jug
borša	bag
brdavs	brute
britof	cemetery
bruc	freshman
budalo	fool
buteljka	bottle
šimpanz	chimpanzee
prase	piglet
džungla	jungle
šakal	jackal
muflon	mouflon
mrož	walrus
recikliranje	recycling
stroj	machine
nafta	oil
klima	climate
tlak	pressure
prislov	adverb
veznik	conjunction
kavka	jackdaw
otrok	child
skupina	group
kompas	compass
prevod	translation
služba	service
podrobnost	detail
papež	pope
klarinet	clarinet
tast	father-in-law
učiteljica	teacher
učitelj	teacher
opat	abbot
brom	bromine
selen	selenium
triolet	triolet
kosinus	cosine
osel	donkey
cenzura	censorship
molekula	molecule
papiga	parrot
zvon	bell
fizika	physics
fonetika	phonetics
ceh	guild
cekin	sequin
cokla	clog
cula	bundle
mah	moss
eksodus	exodus
jaspis	jasper
puran	turkey
satelit	satellite
lokomotiva	locomotive
bolgarščina	bulgarian
češčina	czech
danščina	danish
nizozemščina	dutch
angleščina	english
finščina	finnish
francoščina	french
nemščina	german
grščina	greek
madžarščina	hungarian
irščina	irish
italijanščina	italian
norveščina	norwegian
poljščina	polish
portugalščina	portuguese
slovaščina	slovak
ruščina	russian
španščina	spanish
turščina	turkish
estonščina	estonian
litovščina	lithuanian
avstrijec	austrian
avstrijka	austrian
grkinja	greek
turek	turk
španec	spaniard
španka	spaniard
šved	swede
švedinja	swede
čehinja	czech
bolgar	bulgarian
bolgarka	bulgarian
rus	russian
rusinja	russian
romun	romanian
romunka	romanian
danec	dane
danka	dane
nizozemec	dutchman
anglež	englishman
angležinja	englishwoman
maltežan	maltese
norvežan	norwegian
poljak	pole
poljakinja	pole
portugalec	portuguese
portugalka	portuguese
irec	irishman
italijan	italian
italijanka	italian
finec	finn
finka	finn
francozinja	frenchwoman
nemka	german
vrt	garden
lakot	hunger
špirit	spirit
bratranec	cousin
seč	urine
žolč	bile
noč	night
strup	poison
skrivnost	secret
tveganje	risk
kelt	celt
pozornost	attention
mungo	mongoose
član	member
kri	blood
hrček	hamster
saksofon	saxophone
hašiš	hashish
kratica	abbreviation
potres	earthquake
sistem	system
mineralogija	mineralogy
bazalt	basalt
znanost	science
kajak	kayak
literatura	literature
astrologija	astrology
dendrokronologija	dendrochronology
ekologija	ecology
sekira	axe
tomahavk	tomahawk
zlo	evil
zapornik	prisoner
kemija	chemistry
vojska	army
geografija	geography
ekosistem	ecosystem
astronomija	astronomy
teorija	theory
muzej	museum
melodija	melody
džez	jazz
klor	chlorine
silicij	silicon
aluminij	aluminium
magnezij	magnesium
natrij	sodium
kisik	oxygen
kalcij	calcium
krajina	landscape
brdo	hill
hlače	trousers
junak	hero
galeb	seagull
sokol	falcon
knez	prince
miš	mouse
gospodar	master
ped	span
krščanstvo	christianity
ednina	singular
homoseksualnost	homosexuality
makedonščina	macedonian
glasba	music
aceton	acetone
adaptacija	adaptation
aerodinamika	aerodynamics
branik	bulwark
brazgotina	scar
akvarij	aquarium
ambasador	ambassador
analogija	analogy
anarhist	anarchist
anatomija	anatomy
bedro	thigh
ekonomija	economics
entomologija	entomology
mitologija	mythology
optika	optics
fotografija	photograph
aksiom	axiom
aktinij	actinium
alpaka	alpaca
veleposlanik	ambassador
ambrozija	ambrosia
aglomeracija	agglomeration
možnost	possibility
americij	americium
biokemija	biochemistry
binom	binomial
monom	monomial
simetrija	symmetry
rubidij	rubidium
stroncij	strontium
itrij	yttrium
cirkonij	zirconium
molibden	molybdenum
tehnecij	technetium
rutenij	ruthenium
rodij	rhodium
paladij	palladium
kadmij	cadmium
indij	indium
barij	barium
lantan	lanthanum
cerij	cerium
prometij	promethium
samarij	samarium
gadolinij	gadolinium
terbij	terbium
disprozij	dysprosium
holmij	holmium
tulij	thulium
lutecij	lutetium
tantal	tantalum
renij	rhenium
osmij	osmium
iridij	iridium
talij	thallium
bizmut	bismuth
polonij	polonium
francij	francium
radij	radium
protaktinij	protactinium
plutonij	plutonium
kalifornij	californium
fermij	fermium
mendelevij	mendelevium
dubnij	dubnium
ununtrij	ununtrium
ununpentij	ununpentium
ununseptij	ununseptium
vanadij	vanadium
kobalt	cobalt
cink	zinc
galij	gallium
germanij	germanium
časopis	newspaper
domoljub	patriot
apokalipsa	apocalypse
žep	pocket
violina	violin
porcelan	porcelain
lezbijka	lesbian
sanskrt	sanskrit
ironija	irony
topol	poplar
abak	abacus
uporabnik	user
prispevek	contribution
svak	brother-in-law
princ	prince
bolnišnica	hospital
kopalnica	bathroom
radost	joy
plaža	beach
vrba	willow
rudnik	mine
uš	louse
vrat	neck
jetra	liver
jeza	anger
gasa	street
letalo	airplane
šunka	ham
ležaj	bearing
grm	bush
vodič	guide
dnevnik	diary
razglednica	postcard
govedina	beef
mladost	youth
žalost	sadness
sopomenka	synonym
protipomenka	antonym
vlada	government
strast	passion
laž	lie
noj	ostrich
ličinka	larva
tipkovnica	keyboard
slina	saliva
snaha	daughter-in-law
požar	fire
peč	oven
kobila	mare
dragulj	jewel
iglica	needle
lišaj	lichen
prtljaga	luggage
opeklina	burn
nosorog	rhinoceros
predmet	object
ples	dance
samostan	monastery
bršljan	ivy
slikar	painter
korenje	carrot
postelja	bed
pomaranča	orange
vektor	vector
kukavica	cuckoo
ponos	pride
hiša	house
niša	niche
rojstvo	birth
orgija	orgy
količina	quantity
književnost	literature
grofica	countess
platno	canvas
postaja	station
lubenica	watermelon
trgovina	shop
kuhar	cook
izgovorjava	pronunciation
rožmarin	rosemary
gnosticizem	gnosticism
sonet	sonnet
jama	cave
teden	week
pomlad	spring
izvir	spring
število	number
črka	letter
dežnik	umbrella
trska	cod
heteroseksualnost	heterosexuality
davek	tax
sadež	fruit
vejica	comma
dvopičje	colon
računalnik	computer
rastlina	plant
srebrnina	silverware
narava	nature
oseba	person
petelin	cock
žival	animal
kača	snake
tašča	mother-in-law
svakinja	sister-in-law
čebela	bee
navada	habit
vrtnica	rose
pločevinka	tin
limona	lemon
riž	rice
netopir	bat
sef	safe
baskovščina	basque
maternica	womb
stanje	condition
kapitalizem	capitalism
prstan	ring
glavnik	comb
škatla	box
dvom	doubt
trebuh	belly
odeja	blanket
kunec	rabbit
božanstvo	deity
pogum	courage
grofija	county
komunizem	communism
žrebec	stallion
ponedeljek	monday
torek	tuesday
pomenoslovje	semantics
monoteizem	monotheism
pospešek	acceleration
šola	school
senca	shadow
jetika	tuberculosis
tuberkuloza	tuberculosis
radovednost	curiosity
hrvaščina	croatian
ustnica	lip
trenutek	moment
umor	murder
krastača	toad
lubje	bark
zemljepis	geography
poper	pepper
gleženj	ankle
samomor	suicide
citre	zither
trener	coach
bolnik	patient
slonovina	ivory
pohištvo	furniture
dvoživka	amphibian
lastnina	property
bajonet	bayonet
spojina	compound
sončnica	sunflower
sporočilo	message
vranica	spleen
obljuba	promise
teoretik	theorist
vdova	widow
jajčevec	aubergine
renesansa	renaissance
sedlo	saddle
sviloprejka	silkworm
svetilnik	lighthouse
lotos	lotus
paglavec	tadpole
maček	cat
turist	tourist
ljubezen	love
ptič	bird
mošeja	mosque
ustje	mouth
bolečina	pain
predal	drawer
srb	serb
življenje	life
cesarica	empress
tla	floor
podpičje	semicolon
večerja	dinner
jadro	sail
marelica	apricot
počitek	rest
robidnica	blackberry
spominčica	forget-me-not
zapor	prison
atrij	atrium
gibanje	movement
klorofil	chlorophyll
tuljava	coil
sinagoga	synagogue
makedonec	macedonian
kraljestvo	kingdom
raba	use
krik	cry
steklenica	bottle
škorec	starling
dromedar	dromedary
kristal	crystal
vprašanje	question
kopito	hoof
upanje	hope
jarem	yoke
bombnik	bomber
latinščina	latin
celina	continent
spregatev	conjugation
palača	palace
timijan	thyme
dirka	race
vilice	fork
strategija	strategy
glasbenik	musician
pijača	drink
kazalec	forefinger
opeka	brick
opomba	note
beloruščina	belarusian
ateizem	atheism
ciklon	cyclone
gosenica	caterpillar
usmrtitev	execution
pisarna	office
vojak	soldier
presenečenje	surprise
dimnik	chimney
začetek	beginning
boben	drum
učenec	pupil
zenica	pupil
genocid	genocide
rumenjak	yolk
kateter	catheter
šum	noise
benzen	benzene
pornografija	pornography
sablja	sabre
erekcija	erection
seksologija	sexology
kategorija	category
obsedenost	obsession
ljubosumnost	jealousy
dejavnost	activity
priložnost	opportunity
skupnost	community
vljudnost	politeness
znoj	sweat
pazduha	armpit
tisočletje	millennium
desetletje	decade
moški	man
datelj	date
paradižnik	tomato
golob	pigeon
žafran	saffron
kositer	tin
veriga	chain
gorčica	mustard
steza	path
svinec	lead
svetloba	light
hrbet	back
srajca	shirt
podkev	shoe
napad	attack
škarje	scissors
žoga	ball
krogla	ball
žica	wire
breskev	peach
podoba	image
pomoč	help
čut	sense
klic	call
brca	kick
škof	bishop
polovica	half
priimek	surname
oporoka	will
poljub	kiss
psica	bitch
noht	nail
žebelj	nail
suženj	slave
suženjstvo	slavery
tempelj	temple
čebula	onion
hijena	hyena
kmetija	farm
koruza	maize
rjuha	sheet
pljuča	lungs
čmrlj	bumblebee
klopotača	rattlesnake
enačba	equation
žerjav	crane
bambus	bamboo
kosmulja	gooseberry
denarnica	wallet
veleposlaništvo	embassy
dirigent	conductor
vtis	impression
zemljevid	map
trobenta	trumpet
čaplja	heron
mehkužec	mollusc
žuželka	insect
sesalec	mammal
mravlja	ant
čriček	cricket
skuša	mackerel
sprevodnik	conductor
prevodnik	conductor
detel	woodpecker
žolna	woodpecker
kristjan	christian
roževina	horn
oklepaj	bracket
pevec	singer
sršen	hornet
smodnik	gunpowder
pozavna	trombone
lastovka	swallow
sinica	tit
slezenovec	mallow
oltar	altar
smreka	spruce
orgazem	orgasm
možnar	mortar
prižnica	pulpit
krema	cream
škorenj	boot
kuščar	lizard
sveča	candle
obrv	eyebrow
trepalnica	eyelash
dleto	chisel
pridevnik	adjective
masturbacija	masturbation
kamela	camel
velblod	camel
prevajalec	translator
rešitev	solution
paradoks	paradox
morje	sea
ralo	plough
bojazen	fear
reč	thing
klešče	pliers
vosek	wax
poletje	summer
svinčnik	pencil
indijec	indian
grenivka	grapefruit
trikotnik	triangle
padec	fall
rakun	raccoon
deček	boy
pravica	right
družina	family
zgradba	building
maslo	butter
plašč	coat
razlika	difference
voluhar	vole
rovka	shrew
pesek	sand
spomin	memory
divizija	division
kovnica	mint
prvak	champion
stikalo	switch
srbščina	serbian
časnik	newspaper
steklo	glass
kozarec	glass
politeizem	polytheism
kraljevina	kingdom
stavek	sentence
kopno	land
revija	magazine
obleka	dress
celota	whole
vrednost	value
korenina	root
krivoverec	heretic
prednik	ancestor
kaplja	drop
križanje	crucifixion
zdravica	toast
šahovnica	chessboard
okarina	ocarina
svetnik	saint
rokavica	glove
tjulenj	seal
letališče	airport
domišljija	imagination
perutnina	poultry
depresija	depression
molitev	prayer
krsta	coffin
krempelj	claw
pljučnica	pneumonia
povratnik	tropic
odnos	relation
posteljica	placenta
poldan	noon
nečakinja	niece
puščava	desert
izdajalec	traitor
stožec	cone
slovnica	grammar
generacija	generation
rezultat	result
tkivo	tissue
gospodična	miss
zbirka	collection
organizacija	organization
dogovor	agreement
svojina	property
struktura	structure
hidrat	hydrate
ček	cheque
načelo	principle
površina	surface
prijateljstvo	friendship
razvoj	development
dres	tracksuit
polnoč	midnight
jezikoslovje	linguistics
mišica	muscle
kočija	coach
demokracija	democracy
slovan	slav
rž	rye
šal	scarf
štala	barn
skladnja	syntax
geslo	password
mizantropija	misanthropy
gorivo	fuel
krivda	guilt
stoletje	century
flavta	flute
frekvenca	frequency
torba	bag
mornarica	navy
nikelj	nickel
kovanec	coin
risba	drawing
drozg	thrush
labod	swan
enota	unit
mandolina	mandolin
ugriz	bite
vijak	screw
indijka	indian
jelša	alder
drobnjak	chive
stetoskop	stethoscope
romb	rhombus
terorist	terrorist
ejakulacija	ejaculation
drobiž	change
prebava	digestion
zaklad	treasure
šarenica	iris
urnik	schedule
radirka	eraser
žara	urn
beljak	albumen
potrpežljivost	patience
polotok	peninsula
dimlje	groin
zvitek	scroll
rebro	rib
redkev	radish
pluta	cork
preja	yarn
mošt	must
jezikoslovec	linguist
jur	grand
možgani	brain
ovratnik	collar
likalnik	iron
štorklja	stork
piščanec	chicken
jerebica	partridge
bober	beaver
prašič	pig
rezilo	blade
opuščaj	apostrophe
izvijač	screwdriver
valj	cylinder
nebotičnik	skyscraper
zajtrk	breakfast
gostitelj	host
ogljik	carbon
arzen	arsenic
kosilo	lunch
ulomek	fraction
prostornina	volume
hrup	noise
mezeg	hinny
levinja	lioness
škorpijon	scorpion
jeklo	steel
ropar	robber
zverina	beast
samorog	unicorn
črevo	intestine
vozel	knot
jarek	ditch
nogavica	sock
hrast	oak
bitje	being
članek	article
klovn	clown
hrib	hill
okostje	skeleton
pek	baker
fižol	bean
mesojedec	carnivore
dinozaver	dinosaur
škržat	cicada
podnebje	climate
ščit	shield
tarča	target
lutnja	lute
idila	idyll
klofuta	slap
apnenec	limestone
spalnica	bedroom
toplota	warmth
peteršilj	parsley
relikvija	relic
žepar	pickpocket
mafija	mafia
veselje	happiness
aristokracija	aristocracy
slad	malt
pistacija	pistachio
banja	bath
zlitina	alloy
jazbec	badger
vretence	vertebra
taščica	robin
šoja	jay
bukev	beech
katalonščina	catalan
škrjanec	lark
hobotnica	octopus
tišina	silence
zavesa	curtain
lijak	funnel
merjasec	boar
lobanja	skull
bosanščina	bosnian
genij	genius
vožnja	fare
ščegetavček	clitoris
zadnjik	anus
obmodek	epididymis
joga	yoga
opatinja	abbess
sklanjatev	declension
mavrica	rainbow
komet	comet
enakonočje	equinox
vhod	entrance
golobica	dove
kozorog	ibex
hermelin	ermine
dihur	polecat
vojvoda	duke
žrebe	foal
majoneza	mayonnaise
prostitucija	prostitution
kavarna	café
prazeodim	praseodymium
kirij	curium
bretonec	breton
bretonščina	breton
posameznik	individual
kinin	quinine
hladilnik	refrigerator
sovraštvo	hatred
zahteva	demand
regrat	dandelion
kljunaš	platypus
sadovnjak	orchard
travnik	meadow
vrč	jug
artefakt	artifact
gozdarstvo	forestry
predlog	preposition
metafizika	metaphysics
učinek	effect
čarovnica	witch
rabarbara	rhubarb
mrhovina	carrion
gimnazija	gymnasium
pesnik	poet
tisa	yew
kneginja	princess
sadje	fruit
oglas	advertisement
pestič	pistil
pozitron	positron
mezon	meson
barion	baryon
bozon	boson
kostnica	ossuary
prašnik	stamen
kobilica	grasshopper
razpelo	crucifix
begunec	refugee
mehur	bladder
zapestje	wrist
arterija	artery
diskriminacija	discrimination
škripec	pulley
griža	dysentery
smola	resin
gonoreja	gonorrhea
paleolitik	paleolithic
presredek	perineum
skrotum	scrotum
modnik	scrotum
biseksualnost	bisexuality
seksualnost	sexuality
perverzija	perversion
drkanje	wank
osebnost	personality
dojenček	baby
inštitut	institute
kakovost	quality
tetoviranje	tattoo
popek	navel
socvetje	inflorescence
bližnjica	shortcut
zgodba	story
snežak	snowman
suša	drought
pripona	suffix
predpona	prefix
prostor-čas	spacetime
judovstvo	judaism
cesarstvo	empire
izboljšava	improvement
narečje	dialect
obsečnica	prostate
izmena	shift
homoseksualec	homosexual
kurdščina	kurdish
neodim	neodymium
relativnost	relativity
arašid	peanut
kanjon	canyon
resnica	truth
mušnica	toadstool
ksenofobija	xenophobia
obrezovanje	circumcision
gejzir	geyser
falzet	falsetto
nekropola	necropolis
terarij	terrarium
energija	energy
zmagovalec	winner
shizofrenija	schizophrenia
štor	stump
pomembnost	importance
kanton	canton
zlog	syllable
snežinka	snowflake
lažnivec	liar
trakulja	tapeworm
dvojček	twin
muzikologija	musicology
ideologija	ideology
čevelj	shoe
socializem	socialism
brki	moustache
jajčnik	ovary
kapetan	captain
naglas	accent
rudar	miner
ovčar	sheepdog
lokacija	location
svizec	marmot
sljuda	mica
vojščak	warrior
hmelj	hop
pulzar	pulsar
naključje	coincidence
kladivce	malleus
predvidljivost	predictability
violončelo	violoncello
česen	garlic
demiurg	demiurge
stopnišče	staircase
geodezija	geodesy
trizob	trident
orakelj	oracle
žleza	gland
pogodba	contract
dvojina	dual
federacija	federation
amfiteater	amphitheater
paranoja	paranoia
patologija	pathology
dobrava	wood
halucinacija	hallucination
aerolit	aerolite
prepucij	prepuce
bivši	ex-boyfriend
orlič	eaglet
praporščak	ensign
praded	great-grandfather
stotnik	captain
kapetanka	captain
stotnica	captain
majorka	major
polkovnica	colonel
vojakinja	soldier
zastavnica	ensign
borec	fighter
policist	policeman
miličnik	policeman
sabotaža	sabotage
cirilica	cyrillic
scenarij	scenario
poljedelstvo	agriculture
volkodlak	werewolf
tolmač	interpreter
karamela	caramel
zmaga	victory
luteranec	lutheran
središče	center
makedonka	macedonian
macesen	larch
revolucija	revolution
žamet	velvet
dren	dogwood
prakrt	prakrit
podmornica	submarine
zvezek	notebook
žveplo	sulfur
julij	july
junij	june
čivava	chihuahua
stečaj	bankruptcy
kvartet	quartet
šank	bar
hren	horseradish
husit	hussite
amarant	amaranth
ščir	amaranth
vsebina	content
gabez	comfrey
ginekologija	gynecology
epistemologija	epistemology
friz	frieze
brek	break
cvetje	flowers
hudič	devil
oranža	orange
milisekunda	millisecond
zdravljica	toast
navdih	inspiration
estonka	estonian
latvijec	latvian
latvijka	latvian
litovec	lithuanian
litovka	lithuanian
albanec	albanian
albanščina	albanian
kitajka	chinese
srbkinja	serb
slovanka	slav
ekonomist	economist
prt	tablecloth
ograja	fence
vodja	leader
mirta	myrtle
hurija	houri
belina	whiteness
zvok	sound
prisotnost	presence
raderfordij	rutherfordium
siborgij	seaborgium
borij	bohrium
hasij	hassium
majtnerij	meitnerium
darmštatij	darmstadtium
rentgenij	roentgenium
livermorij	livermorium
oblikoslovje	morphology
kopel	bath
nosilec	carrier
mladina	youth
mladič	lad
ustreznik	equivalent
plutokracija	plutocracy
teokracija	theocracy
mikrosekunda	microsecond
oddajnik	transmitter
jedec	eater
vsejedec	omnivore
vegetarijanec	vegetarian
nevihta	storm
moča	rain
močerad	salamander
komarček	fennel
ajd	heathen
lisička	chanterelle
smrček	morel
heksagon	hexagon
aragonit	aragonite
hidrolog	hydrologist
sobana	hall
zrklo	eyeball
želodec	stomach
batiskaf	bathyscaphe
občinstvo	audience
pedagogika	pedagogy
mikrometer	micrometer
skodelica	cup
igrača	toy
stranišče	toilet
komolec	elbow
naravnost	naturalness
šilček	sharpener
zakristija	sacristy
delavec	worker
brv	bridge
poklic	profession
aktualizacija	update
slaščičarna	sweetshop
zaščita	protection
optičen	optical
bralnik	reader
programje	software
sorojenec	sibling
popoldan	afternoon
tavžent	thousand
usoda	destiny
slamica	straw
polbrat	stepbrother
vpliv	influence
sirotka	whey
pragermanščina	proto-germanic
praslovanščina	proto-slavic
prababica	great-grandmother
hasidizem	hassidism
megavat	megawatt
platana	planetree
pogoj	condition
soprog	husband
nagelj	carnation
apartma	apartment
senožet	meadow
drva	firewood
nedoločnik	infinitive
deležnik	participle
namenilnik	supine
janež	anise
psevdoznanost	pseudoscience
mrest	frogspawn
kraja	theft
siriščnik	abomasum
loboda	saltbush
rman	yarrow
brglez	nuthatch
skvoš	squash
kokalj	corncockle
krivec	billhook
čemaž	ramson
vratič	tansy
skrilavec	schist
dovtip	joke
burja	bora
lušček	silicle
voh	olfaction
polst	felt
uganka	riddle
lovka	tentacle
zapornica	barrier
kašča	granary
kolcanje	hiccups
izpuščaj	rash
vodnjak	well
krč	spasm
pražival	protozoon
krogi	circle
otrobi	bran
ozvezdje	constellation
ščipalec	scorpion
otroštvo	childhood
zgodovinar	historian
polmesec	crescent
igrišče	playground
demografija	demography
oglje	charcoal
pristanišče	harbor
homeopatija	homeopathy
pesništvo	poetry
vodvil	vaudeville
brisača	towel
melona	melon
omaka	sauce
pištola	pistol
sužnja	slave
tovarna	factory
špinača	spinach
žimnica	mattress
nosečnost	pregnancy
nosečnica	mother-to-be
žeja	thirst
raztresenost	absent-mindedness
požig	arson
kleptokracija	kleptocracy
hidroplan	seaplane
gozdar	forester
robida	bramble
jupiter	jupiter
leon	leo
saturn	saturn
mesija	messiah
irak	iraq
kamerun	cameroon
katalonija	catalonia
čad	chad
bosna	bosnia
afganistan	afghanistan
makedonija	region
vojvodina	vojvodina
bog	god
kuba	cuba
kuk	slovenia
luna	moon
mars	mars
monako	city-state
moskva	moscow
pluton	pluto
uran	uranus
japonska	japan
neptun	neptune
indija	india
albanija	albania
andora	andorra
armenija	armenia
beograd	belgrade
italija	italy
belgija	belgium
španija	spain
palestina	palestine
aljaska	alaska
tadžikistan	country
nizozemska	netherlands
libanon	lebanon
pariz	caplc
norveška	norway
poljska	poland
maroko	morocco
tajvan	taiwan
buda	buddha
švedska	sweden
irska	ireland
kenija	kenya
eritreja	eritrea
anglija	england
latvija	latvia
sirija	syria
jezus	jesus
kristus	christ
sardinija	sardinia
izrael	country
bolgarija	bulgaria
finska	finland
francija	france
slovaška	slovakia
turčija	turkey
romunija	romania
portugalska	portugal
grčija	greece
nemčija	germany
avstrija	austria
kreta	crete
kavkaz	caucasus
ahil	achilles
gambija	gambia
gana	ghana
gvineja	guinea
komori	comoros
liberija	liberia
sejšeli	seychelles
tanzanija	tanzania
zambija	zambia
filipini	philippines
indonezija	indonesia
maldivi	maldives
malezija	malaysia
britanija	britain
koreja	korea
azerbajdžan	azerbaijan
wikislovar	wiktionary
mehika	mexico
švica	switzerland
avstralija	australia
jordanija	jordan
bahrajn	bahrain
tajska	thailand
kleopatra	cleopatra
epir	region
miha	michael
božič	christmas
tomaž	thomas
pepelka	cinderella
vltava	river
škotska	scotland
mojzes	moses
wikipedija	wikipedia
mohamed	muhammad
kitajska	china
belorusija	belarus
hrvaška	croatia
galicija	galicia
kobarid	town
alžirija	algeria
donava	danube
teksas	texas
tunizija	tunisia
mavretanija	mauritania
mjanmar	myanmar
istra	istria
pitagora	pythagoras
sokrat	socrates
vodnar	aquarius
transilvanija	transylvania
ciper	cyprus
pohorje	pohorje
andaluzija	andalusia
grenlandija	greenland
višnu	vishnu
kamčatka	kamchatka
sicilija	sicily
heziod	hesiod
herodot	herodotus
monarhija	monarchy
kalifornija	california
oligarhija	oligarchy
zae	uae
sibirija	siberia
češkoslovaška	czechoslovakia
avstro-ogrska	austria-hungary
sena	seine
piemont	piedmont
bretanja	brittany
ogrska	hungary
mihaela	michaela
habakuk	habakkuk
lombardija	lombardy
gvajana	country
nehemija	nehemiah
jeremija	jeremiah
zlatorog	goldenhorn
biti	beat
meti	rub
militi	soap
jesti	eat
sanjati	dream
molsti	milk
prati	wash
topiti	melt
briti	shave
nesti	carry
polzeti	crawl
reči	say
zlomiti	break
blesteti	glitter
presti	spin
postati	become
veti	blow
amputirati	amputate
videti	see
spati	sleep
ubiti	kill
rezati	cut
sovražiti	hate
razumeti	understand
govoriti	speak
izgubiti	lose
vezati	tie
slikati	paint
nositi	carry
jahati	ride
kupiti	buy
voziti	drive
prositi	ask
žrtvovati	sacrifice
umreti	die
deževati	rain
vreči	throw
pogoltniti	swallow
vedeti	know
spoznati	know
obiskati	visit
obljubiti	promise
pristati	land
počivati	rest
uspeti	succeed
priti	come
zakleniti	lock
pogrešati	miss
zažgati	burn
brcniti	kick
tvegati	risk
rešiti	save
oditi	go
obesiti	hang
snežiti	snow
hoteti	want
pobrati	collect
presenetiti	surprise
poznati	know
črkovati	spell
obraniti	defend
blagosloviti	bless
ugrizniti	bite
prijaviti	enter
spomniti	remember
masturbirati	masturbate
pihati	blow
zbežati	escape
pričakovati	expect
samozadovoljevati	masturbate
uporabiti	use
pasiva	graze
jokati	cry
zaspati	oversleep
spogledovati	flirt
zbirati	collect
objeti	hug
dotakniti	touch
pasejo	graze
predvideti	predict
želeti	wish
podkovati	shoe
spominjati	remember
zidati	build
bežati	flee
metati	throw
peči	bake
leči	lay
sneti	remove
risati	draw
dedovati	inherit
skriti	hide
manjkati	lack
sposoditi	borrow
izposoditi	borrow
posoditi	lend
vstopiti	enter
obiskovati	visit
šiliti	sharpen
poklicati	call
izklopiti	disable
modernizirati	modernize
molčati	silent
gosti	play
ruvati	uproot
jemati	take
daljšati	lengthen
žgati	burn
jasniti	understand
ločiti	separate
zgrešiti	miss
padem	fall
padeš	fall
pademo	fall
paseta	graze
sezi	reach
seče	cut
otava	aftergrass
otava	aftermath
gosar	gosherd
gosar	gooseherd
solaren	solar
muskularen	muscular
gnostičen	gnostic
obrazen	facial
skrotalen	scrotal
orgiastičen	orgiastic
rektalen	rectal
vrstilen	ordinal
srednjevaloven	mediumwave
kratkovaloven	shortwave
nedovršen	imperfective
abeceden	alphabetical
gozden	forest
ogor	conger
klošč	tick
grod	frame
grod	breast
bukselj	fool
mrkev	carrot
klokan	kangaroo
maltežanka	maltese
autokracija	autocracy
bezjak	fool
odol	valley
pornograf	pornographer
samum	simoom
kapibara	capybara
žrebica	filly
suspenzorij	jockstrap
praporščakinja	ensign
miličnica	policewoman
palčnik	mitten
nekrofilija	necrophilia
bretonka	breton
jagnjec	lamb
božur	peony
vrstnost	type
vrstnost	sort
herbivor	herbivore
travojedec	graminivore
travojedec	grass-eater
birtija	inn
birtija	pub
birtija	tavern
postol	shoe
huriska	houri
čifut	jew
prga	grit
kokolj	corncockle
vrabelj	sparrow
čober	calamint
grust	disgust
ščirec	ulcer
ščirec	amaranth
klepati	knock
šantati	limp
šiti	sew
diti	smell
mreti	die
gročiti	grok
otrpniti	stiffen
odvreti	open
sloveti	famous
sloveti	reknowned
paseš	graze
pasete	graze
pasemo	graze
padita	fall
padiva	fall
sečeš	cut
