novea	new
vî	old
rôze	pink
tchôd	warm
pezant	heavy
flåwe	weak
djonne	young
fonetike	phonetic
orandje	orange
sicret	secret
botanike	botanical
måye	male
cintrå	central
waloncåzant	walloon-speaking
feneyant	lazy
shijhinme	sixth
setinme	seventh
ûtinme	eighth
dijhinme	tenth
anke	anchor
carbone	carbon
lak	lake
pire	stone
tere	earth
no	name
rogne	scabies
både	jenny
meur	wall
lét	bed
voye	road
seur	acid
tchivå	horse
eure	hour
fevrî	february
moes	month
foete	liver
impire	empire
bire	beer
pexhî	peach
ombe	shadow
ôr	gold
mwin	hand
halene	worm
tchant	song
oujhea	bird
tiesse	head
åbe	tree
biesse	animal
bwès	forest
coine	horn
grinne	seed
nivaye	snow
nute	night
oû	egg
djambe	leg
foumire	smoke
anêye	year
plome	feather
pazea	footpath
rotche	rock
pougn	fist
tchet	cat
waerbea	warble
canada	potato
iye	island
vatche	cow
djudi	thursday
mårdi	tuesday
mierkidi	wednesday
vénrdi	friday
semdi	saturday
motî	dictionary
pingne	comb
aschoûtrece	stethoscope
sociolinwince	sociolinguistics
linwince	linguistics
linwincieuse	linguist
fiesse	feast
sustantif	noun
ratournaedje	translation
singulî	singular
pådje	page
copene	discussion
lingaedje	language
adviebe	adverb
pårtixhant	denominator
sacwè	thing
sistinme	system
oxhitrawôze	osteoporosis
calindrî	calendar
dinrêye	cereal
tchambe	room
proteyene	protein
vijhén	neighbor
elodjaedje	username
matante	aunt
mononke	uncle
esbåtche	draft
rilidjon	religion
indje	species
ringne	kingdom
hintche	left
edvincion	invention
arondixhmint	arrondissement
pårlumint	parliament
bresseu	brewer
antolodjeye	anthology
paris	paris
rome	rome
danube	danube
male	malta
fidji	fiji
arabe	arabic
espagnol	spanish
sarde	sardinian
finlande	finland
francès	french
maltès	maltese
grece	greece
beldjike	belgium
urope	europe
awan	awans
andore	andorra
aldjereye	algeria
perou	peru
azeye	asia
picårdeye	picardy
afrike	africa
bastogne	bastogne
almand	german
hardenne	ardennes
neyerlandès	dutch
itålyin	italian
daenwès	danish
izlande	iceland
norvedje	norway
itåleye	italy
rûsseye	russia
marok	morocco
mecsike	mexico
rûsse	russian
hongrwès	hungarian
djaponès	japanese
suwedwès	swedish
estoneye	estonia
esloveneye	slovenia
roumaneye	romania
almagne	germany
lussimbork	luxembourg
hongreye	hungary
daenmåtche	denmark
chîpe	cyprus
otriche	austria
eslovakeye	slovakia
latén	latin
oucrinne	ukraine
corêye	korea
tunizeye	tunisia
moritanreye	mauritania
guinêye	guinea
årmeneye	armenia
mongoleye	mongolia
djeyordjeye	georgia
turkeye	turkey
israyel	israel
djordaneye	jordan
ostraleye	australia
årdjintene	argentina
paragway	paraguay
eritrêye	eritrea
namibeye	namibia
etiopeye	ethiopia
djamayike	jamaica
grenåde	grenada
albaneye	albania
somaleye	somalia
swisse	switzerland
braezi	brazil
ecwåteur	ecuador
taylande	thailand
samowa	samoa
lîchtensteyn	liechtenstein
nawouro	nauru
palawou	palau
djapon	japan
lawosse	laos
cambodje	cambodia
kuweyt	kuwait
azerbaydjan	azerbaijan
kirgiztan	kyrgyzstan
izlandès	icelandic
norvedjin	norwegian
estonyin	estonian
litwanyin	lithuanian
eterlingwa	interlingua
faeroyès	faroese
galicyin	galician
hawayin	hawaiian
finwès	finnish
trouk	turkish
oucrinnwès	ukrainian
lussimbordjwès	luxembourgish
roumin	romanian
limbôr	limbourg
lidje	liege
nameur	namur
hinnot	hainaut
limbork	limburg
brussele	brussels
suwedwesse	sweden
stocom	stockholm
wîne	vienna
londe	london
copenhågue	copenhagen
walonreye	wallonia
bucaresse	bucharest
tchicago	chicago
wachintone	washington
kebek	quebec
sascatchewane	saskatchewan
budapesse	budapest
rén	rhine
escô	scheldt
dwero	douro
simwès	semois
wål	waal
nîmegue	nijmegen
seure	sauer
mouze	meuse
tchini	chiny
fleuru	fleurus
tchålerwè	charleroi
årlon	arlon
måmdiy	malmedy
mont	mons
wareme	waremme
vervî	verviers
vierton	verton
manhé	manhay
erezêye	érezée
rindeu	rendeux
leglijhe	léglise
faiviè	fauvillers
habâ	habay
cînè	ciney
djedene	gedinne
djeve	gesves
flipveye	philippeville
florefe	floreffe
virwinvå	viroinval
hamwè	hamois
metet	mettet
hamwer	hamoir
modåve	modave
clavir	clavier
haneu	hannut
bassindje	bassenge
doncél	donceel
flémåle	flémalle
welkenrote	welkenraedt
ripouwaryin	ripuarian
aiwêye	aywaille
beurdene	burdinne
lîssin	lincent
ååbel	aubel
wazedje	wasseiges
esneu	esneux
dålem	dalhem
lierneu	lierneux
djouprele	juprelle
anse	ans
antweon	antoing
manadje	manage
framriye	frameries
djerpene	gerpinnes
fårcene	farciennes
crusnêye	crisnée
ståvleu	stavelot
mårcin	marchin
indji	engis
brudjlete	brugelette
momgniye	momignies
kievrin	quiévrain
lissene	lessines
anderluwe	anderlues
bernissåt	bernissart
sinefe	seneffe
cargnon	quaregnon
timpu	estaimpuis
colfontinne	colfontaine
beleul	belœil
astire	hastière
ohè	ohey
sambveye	sambreville
sombrefe	sombreffe
vresse	vresse-sur-semois
djiblou	gembloux
etåle	étalle
gouvi	gouvy
dåvdisse	daverdisse
ramiêye	ramillies
bôvetchén	beauvechain
incoû	incourt
élessene	hélécine
tchåsse	chastre
djinape	genappe
nivele	nivelles
tcheslet	châtelet
havlondje	havelange
bierlô	berloz
djer	geer
antene	anthisnes
stoumont	stoumont
barbåde	barbados
infler	swell
floter	float
viker	live
dner	give
atouwer	tutoie
rnåder	vomit
tchair	fall
ashir	sit
bouxhî	hit
broûler	burn
coûkî	lie
doirmi	sleep
froyî	rub
greter	scratch
netyî	wash
schåvler	dig
shofler	blow
tchessî	hunt
tuzer	think
xhorbi	wipe
schover	sweep
ramessî	bless
prononcî	pronounce
disfacer	delete
discovri	discover
abayî	bark
diswijhî	dull
ratindåve	foreseeable
ratindåve	predictable
lotchet	lock
lotchet	goatee
milet	millet
indonesyin	indonesian
ilinwès	illinois
monreyål	montreal
taedje	tagus
tornè	tournai
bruniau	brunehaut
